Entities,neg,pos,neu,total_articles,Count
Donald Trump,38,61,44,143,1165
CNN,116,106,82,304,791
President,74,175,119,368,368
United States,33,20,21,74,331
Michelle Obama,2,4,2,8,284
Anthony Bourdain,2,4,1,7,279
Trump,13,10,10,33,217
White House,19,29,10,58,198
Scott Pruitt,2,3,6,11,185
Wednesday,42,29,50,121,184
President Obama,4,7,2,13,170
China,16,13,12,41,168
Kim Jong Un,5,13,5,23,168
Thursday,31,28,33,92,157
Washington,24,42,26,92,150
Facebook Messenger,0,0,148,148,148
American,27,20,27,74,141
Barack Obama,6,15,9,30,141
US,20,10,17,47,138
Twitter,14,26,26,66,136
Republicans,18,13,4,35,126
Wilbur Ross,7,2,4,13,122
Donald J. Trump,5,5,2,12,117
Hillary Rodham Clinton,0,0,1,1,117
President-elect,20,86,7,113,113
presidente,14,21,74,109,109
president,31,35,42,108,108
Harvey,1,0,0,1,108
NASA,2,4,5,11,105
Sasha Obama,1,2,0,3,103
Democrats,11,12,10,33,102
North Korea,8,10,7,25,96
Tuesday,26,8,23,57,92
FBI,9,6,5,20,91
Steven Mnuchin,2,2,5,9,88
Chinese,9,11,8,28,87
Sarah Sanders,0,0,3,3,87
Facebook,4,21,16,41,86
New York,14,18,38,70,86
Chelsea Manning,3,0,3,6,85
Estados Unidos,5,9,15,29,85
Mike Pence,2,10,2,14,82
Senate,12,14,11,37,82
Congress,19,14,11,44,80
Betsy DeVos,0,2,6,8,78
Windell Boutte,1,0,0,1,78
Guatemala,8,2,4,14,77
Stormy Daniels,2,0,2,4,77
U.S.,10,7,9,26,75
Texas,3,3,2,8,71
America,18,15,7,40,66
Markeith Loyd,1,0,1,2,64
Venezuela,3,1,3,7,62
Americans,17,13,8,38,61
Chuck Schumer,5,3,3,11,61
Dow Jones Trademark Holdings LLC,12,0,0,12,60
Friday,14,10,13,37,60
Iran,4,3,7,14,60
Mars Curiosity Rover,0,1,0,1,59
Sen.,16,21,21,58,58
Standard & Poor's Financial Services LLC,12,0,0,12,58
Kate Spade,7,0,2,9,57
"Thu June 7, 2018",6,5,46,57,57
Tony Bourdain,0,3,0,3,57
House,16,8,3,27,55
CNN en Español,1,2,8,11,54
United States of America,0,3,1,4,54
North Korean,2,15,3,20,53
Paul Ryan,3,4,4,11,53
Aaron Stokes,1,0,0,1,52
ZTE,4,2,1,7,52
Russia,9,12,8,29,51
Russian,4,10,8,22,51
General Noriega,0,0,1,1,50
CEO,11,18,20,49,49
CNNMoney,6,14,22,42,49
Gambia,0,1,2,3,48
Obama,2,9,5,16,47
Mexico,11,6,6,23,46
Mount Everest,0,1,0,1,46
NORTH KOREAN,0,0,2,2,46
Prime Minister,8,19,18,45,45
Giuliani,4,3,2,9,45
Republican,10,13,11,34,44
Cabinet,2,15,2,19,42
Omar Mateen,2,0,0,2,42
California,4,7,7,18,41
Democratic,8,12,7,27,41
London,6,5,12,23,41
Pyongyang,4,3,4,11,41
Keith Davidson,1,0,0,1,41
director,7,14,19,40,40
estadounidenses,1,1,5,7,40
Oval Office,2,9,2,13,40
James Comey,1,1,0,2,39
Dr.,13,6,19,38,38
Israel,5,4,7,16,38
John Mina,2,0,0,2,38
Rep.,10,7,21,38,38
Vladimir Putin,4,8,5,17,38
Michael Cohen,1,1,1,3,37
Paul Nehlen,0,1,0,1,37
Environmental Protection Agency,2,3,4,9,36
Justice Department,4,5,1,10,36
Alice Marie Johnson,1,3,0,4,36
Ami Vitale,0,0,2,2,36
President Clinton,1,0,1,2,36
Edward Snowden,2,1,2,5,35
Hillary Clinton,8,11,3,22,35
November,11,10,3,24,35
Pete Souza,2,1,0,3,35
Rex Tillerson,3,2,4,9,35
Oklahoma,6,0,2,8,34
Canada,7,6,1,14,33
doctor,12,9,12,33,33
Emily McDowell,0,0,1,1,33
attorney,9,5,18,32,32
Google,3,4,4,11,32
Houston,1,0,0,1,32
Bernie Sanders,3,2,2,7,31
Japan,5,4,4,13,31
Mike Pompeo,2,4,3,9,31
April,10,6,9,25,30
Bill Clinton,4,2,3,9,30
Organización de Estados,0,0,2,2,30
Angola,0,1,0,1,29
Europe,7,8,4,19,29
Gloria Williams,2,0,1,3,29
India,5,2,1,8,29
Jammeh,1,0,0,1,29
miércoles,3,0,16,19,29
Mick Mulvaney,3,1,0,4,29
Jeff Flake,1,1,1,3,29
Martese Edwards,0,1,0,1,29
British,9,4,7,20,28
Mexican,5,3,3,11,28
Wall Street,4,3,2,9,28
"Wed January 18, 2017",2,1,25,28,28
Emilio Guzmán Bustillos,0,0,1,1,27
Florida,5,4,9,18,27
NFL,3,5,2,10,27
Noor Salman,1,0,0,1,27
Peter Ghassemi,1,0,0,1,27
Tom Price,3,7,2,12,27
Treasury,1,5,3,9,27
United Kingdom,3,2,2,7,27
Domestic Energy Producers Alliance,0,0,1,1,26
Judith Acosta,1,0,0,1,26
Julian Assange,1,3,2,6,26
Justin Trudeau,4,2,0,6,26
Senegal,3,0,2,5,26
Mars,0,1,1,2,26
Singapore,1,10,3,14,26
ISIS,7,1,6,14,25
Kevin O'Leary,1,0,0,1,25
Republican Party,2,1,2,5,25
Shinzo Abe,2,9,0,11,25
two years,11,5,8,24,25
Apple,2,7,3,12,24
Boko Haram,0,0,2,2,24
Britain,2,2,2,6,24
Cable News Network,12,0,0,12,24
Chicago Mercantile Exchange Inc.,0,3,9,12,24
FactSet Research Systems Inc.,0,0,12,12,24
Germany,1,4,3,8,24
judge,12,2,10,24,24
Monday,9,4,7,20,24
"Morningstar, Inc.",0,0,12,12,24
Obama administration,7,3,5,15,24
South Korea,4,6,3,13,24
UK,5,2,5,12,24
Elvis,0,2,0,2,24
Michael Avenatti,3,0,1,4,24
Oscar Morales Flores,1,0,0,1,24
Ovidio García Suárez,2,0,0,2,24
Chicago,3,3,2,8,23
EU,7,2,2,11,23
Fox,2,3,1,6,23
France,4,5,3,12,23
George W. Bush,1,8,1,10,23
Hong Kong,4,3,6,13,23
Japanese,3,8,2,13,23
John Zhang,0,0,1,1,23
Leopoldo López,0,1,1,2,23
México,4,2,4,10,23
OneWest Bank,2,0,0,2,23
Alexander Hamilton,0,0,1,1,22
Capitol Hill,10,5,2,17,22
Casa Blanca,2,1,5,8,22
Israeli,3,3,4,10,22
Jared Kushner,2,5,2,9,22
jueves,2,3,9,14,22
Mali,4,0,3,7,22
Nicolás Maduro,0,1,2,3,22
Rick Perry,0,3,1,4,22
Sunday,10,2,6,18,22
"Thu January 19, 2017",0,0,22,22,22
Andy Spade,3,0,0,3,22
Boris Johnson,1,1,0,2,22
Ralph Peters,1,0,0,1,22
chairman,3,6,12,21,21
Colombia,2,2,4,8,21
Kamiyah Mobley,2,0,0,2,21
Ricky Gray,3,0,0,3,21
South Korean,1,1,6,8,21
tweeted,2,5,2,9,21
Xi Jinping,4,4,0,8,21
BlackBerry Key2,1,0,0,1,21
Eevee,1,0,0,1,21
General Electric,2,0,0,2,21
New York City,0,6,1,7,21
Tacita Dean,0,0,1,1,21
Afghanistan,4,1,1,6,20
attorney general,6,4,10,20,20
Barack Obama Casi,0,1,0,1,20
Central Italy,2,0,0,2,20
chief,5,5,10,20,20
CNN Español,3,6,9,18,20
DNA,4,1,2,7,20
governor,7,6,7,20,20
Isidro Baldenegro López,0,2,0,2,20
Middle East,1,5,3,9,20
United Nations,5,1,3,9,20
Vice President,3,8,9,20,20
James Wolfe,1,0,0,1,20
Robert Mueller,2,8,1,11,20
Rudy Giuliani,2,2,4,8,20
Adama Barrow,2,0,1,3,19
Attorney General,7,6,6,19,19
Italian,3,0,5,8,19
January,4,3,1,8,19
Jeff Sessions,2,2,5,9,19
Joe Biden,2,0,4,6,19
Keith Ellison,0,0,1,1,19
martes,3,1,8,12,19
NBC,1,4,4,9,19
Rep. John Lewis,2,1,0,3,19
Secretary of State,5,8,6,19,19
tweet,4,6,3,13,19
viernes,0,2,7,9,19
Bobby Paul Edwards,0,0,1,1,19
Huma Abedin,1,0,1,2,19
Malcolm Jenkins,1,1,0,2,19
Shenzhen Zhongxingxin Telecommunications Equipment,1,0,0,1,19
Angela Merkel,1,4,1,6,18
Argentina,1,0,2,3,18
European,3,4,5,12,18
Fox News,8,3,1,12,18
French,3,7,2,12,18
Josephine,0,0,1,1,18
Libya,2,2,2,6,18
Moscow,2,4,2,8,18
Sara Wilkins,2,0,0,2,18
South Carolina,0,6,7,13,18
Speaker,3,7,8,18,18
Fred Trump,0,0,1,1,18
G7,2,2,1,5,18
Ivan Timofeev,1,0,0,1,18
Michael Ruhlman,0,2,0,2,18
Moon Jae-in,0,1,2,3,18
الخميس,5,9,0,14,18
Raghuveer Kura,1,0,0,1,18
SpaceX Starman,0,1,0,1,18
African-American,3,2,3,8,17
Debbie Wasserman Schultz,1,0,1,2,17
December,4,3,8,15,17
Democratic National Convention,0,2,1,3,17
Donald Trump Inauguration,0,1,0,1,17
HLN,2,1,1,4,17
Jeff Bagwell,0,0,2,2,17
Manhattan,6,3,1,10,17
Muslim,1,3,2,6,17
Secretary,1,9,7,17,17
Thomas Friedman,0,0,1,1,17
Bryan Colangelo,1,0,0,1,17
Chapecoense,1,0,1,2,17
Huawei,0,1,1,2,17
Jesús Santrich,0,0,1,1,17
Alexis Manigo,0,0,1,1,16
Amazon,3,0,5,8,16
Bedouin,1,0,0,1,16
Ben Carson,1,2,1,4,16
Cuba,2,2,3,7,16
Fabrizio Curcio,2,0,0,2,16
German,2,4,5,11,16
Getty Images,3,4,4,11,16
Kelsey Crowe,0,0,1,1,16
Knowles,0,1,0,1,16
Latin America,2,4,2,8,16
Michigan,0,3,5,8,16
Navient,2,0,0,2,16
The New York Times,4,2,7,13,16
Theresa May,4,2,1,7,16
two minutes,13,1,0,14,16
Imran Awan,0,0,1,1,16
Marian Goodman Gallery Dean,0,0,1,1,16
Peter Coats,0,0,1,1,16
Beijing,7,1,3,11,15
Bobby Ghassemi,1,0,0,1,15
Ecuador,0,0,3,3,15
Ejército de Liberación Nacional,0,1,0,1,15
five years,5,1,5,11,15
Michael Lewis,0,0,1,1,15
Obamas,0,3,0,3,15
Office of Government Ethics,1,1,0,2,15
Plasco,2,0,1,3,15
Randal McCloy,1,0,0,1,15
Silicon Valley,5,1,1,7,15
Tehran,4,0,1,5,15
Trump Tower,2,2,2,6,15
vice president,2,7,6,15,15
Virginia,4,1,2,7,15
Elon Musk,0,1,0,1,15
"Fri June 8, 2018",3,2,10,15,15
George Papadopoulos,0,1,0,1,15
Jimmy Cannon,0,1,0,1,15
John Bolton,1,0,2,3,15
Macron,2,1,1,4,15
MIRA,1,1,4,6,15
Ram Sanjeev Alur,1,0,0,1,15
Asia,1,6,3,10,14
Bryce Virgin,1,0,0,1,14
Canadá,0,1,4,5,14
CDC,3,1,4,8,14
Department of Justice,4,1,0,5,14
Earth,3,3,1,7,14
Julian Bailes,1,0,0,1,14
Lady Gaga,0,3,0,3,14
Mitt Romney,1,2,2,5,14
Nancy Sinatra,0,1,0,1,14
Netflix ( NFLX,0,1,0,1,14
دبي,3,8,2,13,14
الإمارات العربية المتحدة,0,10,3,13,14
Pentagon,4,3,2,9,14
President Lincoln,0,1,0,1,14
Rusia,1,0,3,4,14
Ryan Zinke,0,1,2,3,14
S&P Dow Jones Indices LLC,0,0,7,7,14
Supreme Court,1,3,6,10,14
Yahya Jammeh,2,0,0,2,14
Anthony Weiner,1,0,1,2,14
Jerry Maren,0,0,1,1,14
Kim Kardashian West,0,3,1,4,14
حزيران 2018,3,10,1,14,14
Rockport,1,0,0,1,14
Sonos,1,0,0,1,14
Tony,0,2,0,2,14
Berlin,0,2,3,5,13
Democratic Party,4,0,2,6,13
Director,2,6,5,13,13
eight years,3,2,6,11,13
El Salvador,1,0,2,3,13
"Flint, Michigan",1,0,0,1,13
Gambian,1,2,0,3,13
gobernador,5,1,7,13,13
Health and Human Services,2,3,3,8,13
John Lewis,0,1,0,1,13
Lee Greenwood,0,1,1,2,13
Lemurs of Madagascar,0,1,0,1,13
Miami,3,2,2,7,13
Microsoft,1,3,2,6,13
Nike,1,0,1,2,13
presidents,6,1,6,13,13
Savannah Faith Chrisley,1,0,0,1,13
secretary,2,4,7,13,13
secretary of state,2,1,10,13,13
Super Bowl,4,2,3,9,13
Taliban,0,0,3,3,13
Teherán,0,0,1,1,13
tweeting,2,2,0,4,13
West Wing,1,3,2,6,13
WikiLeaks,1,2,1,4,13
Backrub,0,1,0,1,13
Christian Lara,1,0,0,1,13
domingo,1,2,3,6,13
Rey Cruz,0,0,1,1,13
San Miguel Los Lotes,0,2,3,5,13
Texas A,1,0,0,1,13
BATS,0,3,9,12,12
Bob Corker,1,1,1,3,12
Chelsea Clinton,1,1,0,2,12
CIA,0,3,6,9,12
Davos,2,2,3,7,12
DJIA,12,0,0,12,12
EE.UU,1,1,6,8,12
European Union,4,2,3,9,12
God,1,2,1,4,12
Grant Virgin,1,0,0,1,12
Hotel Rigopiano,2,0,0,2,12
Loretta Lynch,4,0,0,4,12
Melania Trump,0,4,1,5,12
NBC Entertainment,0,1,1,2,12
Netflix,1,3,2,6,12
Samsung Group,1,0,0,1,12
two days,5,4,2,11,12
UNITED STATES,0,1,0,1,12
Blaise Compaore,1,0,0,1,12
Frances Beatrix,1,0,0,1,12
Howard Schultz,2,0,0,2,12
Ivanka Trump,0,3,0,3,12
Josh Hawley,1,0,0,1,12
Mark Warner,2,0,1,3,12
Michael Patterson,1,0,0,1,12
Stephanie Clifford,1,1,1,3,12
African,2,3,2,7,11
ambassador,2,5,4,11,11
Arizona,6,1,2,9,11
Boeing,6,1,1,8,11
Democratic National Committee,0,3,1,4,11
Estado,4,1,1,6,11
Ford & Fiat,0,1,0,1,11
Glenn Greenwald,1,0,1,2,11
Goldman Sachs,2,2,2,6,11
IRNA,2,0,1,3,11
James Mattis,1,2,2,5,11
Jay Y. Lee,0,0,1,1,11
Korean,3,0,5,8,11
Linda Moreno,1,0,0,1,11
lunes,0,5,3,8,11
Mark Ramos,1,0,0,1,11
Moscú,3,1,0,4,11
Mr.,5,3,3,11,11
Oracle,1,0,2,3,11
OTAN,0,1,1,2,11
Paris,1,2,4,7,11
Philadelphia,0,4,1,5,11
professor,2,5,4,11,11
Ronald Reagan,0,3,2,5,11
Sean Spicer,2,2,1,5,11
three years,3,4,1,8,11
two decades,5,0,3,8,11
two months,1,6,2,9,11
World Meteorological Organization,0,4,1,5,11
Budapest,1,0,0,1,11
Ethiopia,0,1,0,1,11
Fred Fleitz,1,0,0,1,11
Gavin Patterson,1,0,0,1,11
Hope Hicks,0,1,0,1,11
Steve Stivers,2,0,0,2,11
Africa,3,2,4,9,10
Air Force One,0,4,0,4,10
Andrew Jackson,0,1,1,2,10
Arctic,0,2,0,2,10
Army,1,3,2,6,10
August,3,2,3,8,10
Benjamin Netanyahu,2,1,3,6,10
Corea del Norte,0,0,1,1,10
CRE,1,0,0,1,10
Debra Clayton,1,0,1,2,10
Democrat,1,5,3,9,10
Dow Jones Indices LLC,0,0,5,5,10
estadounidense,1,1,4,6,10
expresidente,3,1,6,10,10
four years,4,3,3,10,10
Gov.,2,4,4,10,10
Ian Schrager,0,1,0,1,10
Jason Chaffetz,1,0,0,1,10
Lakensha Smith Loyd,0,0,1,1,10
Malia,0,2,0,2,10
Martín Lousteau,0,0,1,1,10
NATO,1,4,4,9,10
Nigeria,0,2,2,4,10
Nigerian,5,0,0,5,10
Panama,0,0,1,1,10
puertorriqueño,3,1,6,10,10
Saturday,2,4,3,9,10
Syria,6,0,2,8,10
Turkey,0,1,3,4,10
مجلس النواب,2,2,0,4,10
Veracruz,0,0,1,1,10
William Henry Harrison,1,0,0,1,10
Alexa,2,0,0,2,10
Barbara Bottini,1,0,0,1,10
Ben Ray Luján,1,1,0,2,10
BT,2,1,0,3,10
Chris Cuomo,1,1,2,4,10
Debbie Gatzek Kratter,1,0,0,1,10
Eric Greitens,1,0,0,1,10
John Christopher Smith,1,0,0,1,10
Laurel Irving,1,0,0,1,10
Lisa Page,1,0,0,1,10
Mónica Lewinsky,0,0,1,1,10
Maldives,0,1,1,2,10
Mario Taracena,2,0,0,2,10
Michael Andre Hancock,1,0,0,1,10
Preet Bharara,0,0,1,1,10
Rich Madaleno,0,1,0,1,10
Susan Witt,1,0,0,1,10
Abdel Fattah el-Sisi,1,0,0,1,9
Afghan,1,2,0,3,9
Ambassador,1,3,5,9,9
attorneys,5,3,1,9,9
Australia,1,2,2,5,9
Chairman,4,1,4,9,9
Chris Murphy,1,0,2,3,9
Closed Captioning,0,0,9,9,9
Elaine Chao,0,2,2,4,9
executive,4,3,2,9,9
Fars,3,0,0,3,9
Georgia,3,3,2,8,9
Indian,1,2,3,6,9
International Monetary Fund,1,1,1,3,9
Jamie Dimon,0,2,1,3,9
Janet Yellen,1,0,0,1,9
Jewish,2,4,2,8,9
Jose Eduardo Dos Santos,0,1,0,1,9
Lowell Houser,0,0,1,1,9
Maryland,2,1,3,6,9
Michael Gove,1,0,0,1,9
Minority Leader,3,3,3,9,9
Nikki Haley,1,1,1,3,9
Nobel,2,2,0,4,9
Ohio,5,2,1,8,9
Ollanta Humala,1,0,0,1,9
press secretary,4,5,0,9,9
Rome,0,0,3,3,9
Scott Black Johnston,0,1,0,1,9
Senator,3,2,4,9,9
September,3,1,4,8,9
Skittles,1,0,0,1,9
South Africa,0,2,2,4,9
State Department,3,1,2,6,9
Unión Europea,0,1,1,2,9
West African,3,0,2,5,9
Argentines,1,0,0,1,9
CEOs,1,2,6,9,9
Department,1,2,2,5,9
Goldman,1,1,0,2,9
Joseph Mifsud,1,0,0,1,9
Lonny Shavelson,1,0,0,1,9
Nueva York,3,0,1,4,9
Oprah Winfrey,0,0,1,1,9
Pamela Geller,0,0,1,1,9
partido FARC,0,0,1,1,9
Real Academia Española,0,0,1,1,9
US Department of Agriculture,1,0,0,1,9
Virginia Apgar,1,0,0,1,9
abril,1,2,4,7,8
Adam Frankel,0,1,0,1,8
Amatrice,3,0,0,3,8
an hour,1,2,5,8,8
Arkansas,1,2,1,4,8
Big Mac,1,1,0,2,8
Bowe Bergdahl,0,0,2,2,8
Brasil,0,0,4,4,8
Bryan Harvey,2,0,0,2,8
Clayton Lockett,2,0,0,2,8
Clintons,0,1,1,2,8
Dallas,2,0,2,4,8
Department of Labor,1,0,2,3,8
Disney,1,2,2,5,8
ExxonMobil,0,1,4,5,8
General Motors,0,1,0,1,8
GOP,2,6,0,8,8
Harvard,0,1,3,4,8
Iraq,5,1,1,7,8
Isabel Dos Santos,0,1,0,1,8
Ivanka,0,1,1,2,8
Join us,2,5,1,8,8
Jose Nieves,1,0,0,1,8
Josh Earnest,1,1,2,4,8
Kathleen Hall Jamieson,0,1,0,1,8
Kathy Bilitzke,1,0,0,1,8
Kristin Neff,0,1,0,1,8
Libyan,3,0,0,3,8
Linda Kaye,0,1,0,1,8
Linda McMahon,0,0,1,1,8
Los Angeles,3,3,2,8,8
Luanda,0,0,1,1,8
Maleki,2,0,0,2,8
Mary Pat Christie,1,0,0,1,8
McDonald's,0,0,2,2,8
Medicaid,1,3,2,6,8
Monica Crowley,0,0,1,1,8
Muslims,1,1,2,4,8
National Anthem,3,0,1,4,8
Neil Patel,0,1,0,1,8
Nuestra Visión,0,2,1,3,8
المغرب,0,0,2,2,8
Paul McCartney,0,1,0,1,8
Perú,1,0,2,3,8
prime minister,1,4,3,8,8
Ray Dandridge,2,0,0,2,8
Rick Snyder,1,0,0,1,8
sábado,0,2,3,5,8
Sallie Mae,0,0,1,1,8
Secret Service,3,1,0,4,8
senator,4,4,0,8,8
Spain,2,1,1,4,8
Spanish,6,0,2,8,8
Steve Bannon,0,2,0,2,8
Steve Wynn,1,0,0,1,8
Tiger Ivan Rodriguez,0,0,1,1,8
Tim Raines,0,0,2,2,8
Unión de Naciones Sudamericanas,0,0,1,1,8
United,2,0,0,2,8
Us,0,0,8,8,8
US State Department,3,0,1,4,8
Vice President-elect,1,4,3,8,8
Walter M. Shaub,1,0,0,1,8
Washington's Union Station,0,1,0,1,8
West Virginia,1,3,1,5,8
Albert Watson,0,1,0,1,8
Alotenango,2,0,0,2,8
Anne Schuchat,0,0,2,2,8
Antigone,0,1,0,1,8
Burkina Faso Embassy,1,0,0,1,8
Canadian,3,0,2,5,8
Diana Feldman,1,0,0,1,8
DMZ,0,0,2,2,8
inspector general,4,0,4,8,8
Islam,1,1,1,3,8
James Syhabout,0,2,0,2,8
Jason Wang,0,2,0,2,8
Jeff Denham,0,0,1,1,8
Kim summit,0,2,0,2,8
Mauricio Jaramillo,1,0,0,1,8
Mount Sharp,0,1,0,1,8
MUS'AB ABU-QARIN,1,0,0,1,8
دونالد ترامب,0,0,1,1,8
Secret Service Uniformed Division Officers,0,0,1,1,8
Serbia,0,1,0,1,8
Sergio Cabañas,4,0,0,4,8
Stewart,1,0,0,1,8
Thomas Keller,0,2,0,2,8
مصطفى مدبولي,0,1,0,1,8
Alabama,3,4,0,7,7
Angolan,0,1,0,1,7
Asian,1,1,3,5,7
Atlanta,2,3,2,7,7
Banjul,3,0,0,3,7
Chile,0,1,3,4,7
commander,2,2,3,7,7
David Moscrop,0,0,1,1,7
DJI,7,0,0,7,7
February,1,1,5,7,7
Ford,0,2,1,3,7
Francia,1,1,3,5,7
Gen.,0,4,3,7,7
Gretchen Carlson,0,0,1,1,7
Hispanic,0,2,3,5,7
Italy,3,0,3,6,7
Jimmy Morales,0,0,3,3,7
John Kelly,1,1,3,5,7
José Manuel Morales Marroquín,0,0,1,1,7
José Mujica Mujica,0,0,1,1,7
Julia Haywood,0,1,0,1,7
July,3,4,0,7,7
Kentucky,1,1,0,2,7
Mandy Moore,0,2,0,2,7
Mar-a-Lago,0,3,0,3,7
Massachusetts,3,1,1,5,7
Mike Lee,0,0,1,1,7
Muhammadu Buhari,2,1,0,3,7
New Delhi,2,0,3,5,7
New Jersey,1,1,2,4,7
Oklahoma Corporation Commissioner,1,0,0,1,7
OneWest,1,0,0,1,7
Osama bin Laden,0,0,3,3,7
Parliament,2,1,1,4,7
presidentes,0,3,4,7,7
Presidents,0,2,5,7,7
Prosecutors,4,1,2,7,7
Puerto Rico,0,2,1,3,7
Ray Schulte,1,0,0,1,7
Russian President,4,0,2,6,7
San Francisco,1,1,5,7,7
Saudi Arabia,1,1,2,4,7
Stan Greenberg,0,0,1,1,7
sub-Saharan Africa,0,0,1,1,7
Switzerland,2,1,4,7,7
Time Warner,7,0,0,7,7
Ukraine,1,1,3,5,7
Umm al-Hiran,1,0,0,1,7
UN,0,0,3,3,7
USA,3,0,1,4,7
Warren Buffett,0,1,1,2,7
Will and Grace,0,1,0,1,7
Administrator,1,5,1,7,7
Alexandre Alaphilippe,0,0,1,1,7
Bella,1,0,0,1,7
Communist,0,1,0,1,7
Conred,2,0,1,3,7
Deepu Sudhakaran,1,0,0,1,7
Dick Van Dyke,1,0,0,1,7
"Donald Trump, Jr.",0,0,1,1,7
El Rodeo,1,2,1,4,7
España,0,2,2,4,7
Falcon Heavy,0,1,0,1,7
Fundación del Español Urgente,0,0,1,1,7
Hawai,1,0,0,1,7
Hawaii,0,1,2,3,7
Matt Gaetz,0,1,0,1,7
Matthew Bailly,1,0,0,1,7
Megumi Yokota,1,0,0,1,7
Myanmar,1,0,0,1,7
Northern Ireland,1,0,0,1,7
رمضان,1,0,1,2,7
الأردني,0,3,0,3,7
الرئيس,3,1,3,7,7
Premier League,0,1,0,1,7
Ronal Rodríguez,0,1,0,1,7
Saj Ahmad,1,0,0,1,7
Schuchat,0,0,1,1,7
Supreme Court Judgment,0,1,0,1,7
The Wizard of Oz,0,1,0,1,7
Trey Gowdy,0,2,1,3,7
Uber,1,1,0,2,7
"Wed June 6, 2018",0,0,7,7,7
ABC,0,2,2,4,6
ACLU,1,0,1,2,6
Al Salman,1,0,0,1,6
Alaska,1,3,0,4,6
American Airlines,0,0,3,3,6
Amnesty International,0,3,1,4,6
Android,0,3,2,5,6
Barry Bonds,0,1,1,2,6
BMW,0,1,1,2,6
Brandon Miller,2,2,0,4,6
Buenos Aires,0,2,2,4,6
canciller,0,2,4,6,6
Chancellor,0,1,5,6,6
chief of staff,0,4,2,6,6
Chihuahua,2,0,0,2,6
Clayton,0,1,1,2,6
CNN Health,0,0,2,2,6
Colin Kaepernick,2,1,1,4,6
Commerce Secretary,2,2,2,6,6
Congressman,4,1,1,6,6
Crimea,0,0,4,4,6
"Culican, Mexico",0,0,1,1,6
Dalai Lama,2,2,2,6,6
Dan Kildee,1,0,0,1,6
David Shulkin,0,0,1,1,6
DC,1,2,0,3,6
Department of Housing and Urban Development,2,2,0,4,6
DOJ,3,0,0,3,6
Easter,0,2,2,4,6
Egyptian,1,0,2,3,6
Emmy,0,5,1,6,6
EPA,0,2,1,3,6
Esau Sinnok,2,0,0,2,6
Europa,0,1,0,1,6
executive director,3,1,2,6,6
executives,0,3,3,6,6
Fahrenheit,2,1,3,6,6
Fed,0,0,1,1,6
first lady,0,2,4,6,6
George Washington,0,0,3,3,6
Goldman Environmental Prize,2,0,0,2,6
Governor,5,0,1,6,6
Grant,0,1,0,1,6
Indiana,2,1,3,6,6
Instagram,0,5,1,6,6
Iran deal,2,1,0,3,6
Iranian,3,0,3,6,6
Islamist,0,2,2,4,6
Jacksonville hospital,1,0,0,1,6
Jeh Johnson,0,2,0,2,6
Jeremy Diamond,2,0,4,6,6
Joel Zivot,1,0,0,1,6
Joelle Emerson,0,1,0,1,6
John McCain,1,0,1,2,6
Judge,3,2,1,6,6
jueces,1,1,4,6,6
King,0,4,2,6,6
Leroy Arthur Petry,2,0,0,2,6
Marco Rubio,1,2,0,3,6
Mary Tucker,2,0,0,2,6
Modi,0,1,0,1,6
Moon,1,1,0,2,6
NAFTA,1,1,1,3,6
Nancy Brinker,0,0,1,1,6
National Institutes of Health,1,2,0,3,6
National Security Agency,1,2,0,3,6
NOAA,0,0,2,2,6
الأربعاء,2,2,1,5,6
October,5,0,1,6,6
Orlando,0,0,2,2,6
Palestinian,2,1,0,3,6
Pennsylvania,1,3,1,5,6
Philippines,0,2,0,2,6
Photographer,0,2,4,6,6
Prince William,0,2,0,2,6
prosecutor,2,0,4,6,6
Rann,2,0,0,2,6
Recep Tayyip Erdogan,0,1,0,1,6
Rodrigo Duterte,0,1,0,1,6
Roosevelt,0,1,0,1,6
S&P 500,0,1,1,2,6
Sade Dixon,1,0,1,2,6
Samuel Morales Cabrera,0,1,0,1,6
Save the Children,2,1,0,3,6
Seinfeld,0,1,1,2,6
senators,0,2,4,6,6
Senegalese,2,0,0,2,6
Senior Advisor,0,0,6,6,6
sheriff,4,2,0,6,6
six months,2,2,2,6,6
Sonia Sotomayor,0,2,0,2,6
Thank you very much,1,2,0,3,6
The Wall Street Journal,1,2,3,6,6
The Washington Post,2,1,2,5,6
Theodore Roosevelt,0,3,0,3,6
Trump University,0,1,0,1,6
Tuareg,2,0,0,2,6
Turkish,0,2,1,3,6
Two days,1,0,3,4,6
U.S. debt,1,0,0,1,6
مصر,2,1,1,4,6
US Geological Survey,1,0,2,3,6
Vazrick Nazari,0,1,0,1,6
vicepresidente,0,2,4,6,6
Walmart,1,1,1,3,6
Washington Post,0,1,2,3,6
West,1,2,1,4,6
William R. Harvey,0,0,1,1,6
Wisconsin,1,1,1,3,6
Wyoming,0,1,1,2,6
Yonhap,0,0,2,2,6
Basel,0,1,0,1,6
Bashar,0,1,0,1,6
Bermuda,0,1,0,1,6
BFR,0,1,0,1,6
Bradley Cooper,0,1,0,1,6
Chris Cillizza,1,1,2,4,6
Christiane Amanpour,0,2,0,2,6
Christopher Columbus,0,1,0,1,6
Comcast,0,0,2,2,6
Eritrean,2,0,0,2,6
Fareed Zakaria,0,0,1,1,6
Hungarian,0,0,1,1,6
Hungary,0,0,1,1,6
Ian Siegel,1,0,0,1,6
IKEA Group,0,1,0,1,6
iPhones,2,0,1,3,6
John Shimkus,0,0,1,1,6
Joseph Dunford,0,1,0,1,6
Kitchen Confidential,2,3,0,5,6
Mark Zuckerberg,1,2,1,4,6
Memento Park - Statue Park Museum,1,0,0,1,6
Michael Horowitz,0,0,1,1,6
Michael Pompeo,0,1,0,1,6
Mom,2,0,0,2,6
رئيس الوزراء,2,4,0,6,6
اليمن,1,0,0,1,6
عمر الرزاز,1,0,0,1,6
People for the Ethical Treatment of Animals,0,1,0,1,6
Poplar Bluff Regional Medical Center,1,0,0,1,6
reina,2,0,4,6,6
San Salvador,1,0,1,2,6
Siri,0,1,0,1,6
Southern Poverty Law Center,0,0,1,1,6
Steven Wolf,2,0,0,2,6
US Immigration and Customs Enforcement,1,0,0,1,6
VA,0,1,0,1,6
viernes 8 de junio,0,1,0,1,6
volcán de Fuego,2,0,1,3,6
Xia Boyu,1,0,0,1,6
AAPL,2,3,0,5,5
Al Qaeda,2,0,0,2,5
Alemania,0,1,2,3,5
Americas,4,0,1,5,5
Anderson Cooper,1,1,0,2,5
Andrew Knife Chief,1,0,0,1,5
Aneesh Raman,0,1,0,1,5
Angela Sauaia,0,0,1,1,5
ANSA,2,0,1,3,5
associate professor,1,1,3,5,5
Attorney,2,0,3,5,5
BA,4,0,1,5,5
Beatles,0,1,0,1,5
Bill Ford,1,0,0,1,5
Brazil,1,2,2,5,5
Broadway,0,1,0,1,5
Bryan Morse,1,0,0,1,5
Capitol,1,2,0,3,5
Carla,1,0,0,1,5
Chicago Police Department,1,0,0,1,5
Christians,0,2,0,2,5
Christine Lagarde,1,1,1,3,5
Clinton administration,0,0,1,1,5
CNBC,2,2,1,5,5
Comedians in Cars Getting Coffee,0,1,2,3,5
commander in chief,0,3,2,5,5
Cornell Belcher,1,0,0,1,5
Dana Bash,0,1,4,5,5
David Axelrod,1,0,3,4,5
David Cameron,0,1,2,3,5
Deutsche Bank ( DB,0,0,1,1,5
DJI Opco,5,0,0,5,5
ECOWAS,0,1,0,1,5
Esteban Santiago,0,0,1,1,5
Fiat Chrysler,1,0,0,1,5
Filipinos,0,0,1,1,5
four months,1,1,3,5,5
George H.W. Bush,1,0,3,4,5
Harambe,1,0,1,2,5
Hassan Abbasi,2,0,1,3,5
Hollywood,2,2,1,5,5
Home Affordable Modification Program,1,0,0,1,5
Houston Flash,1,0,0,1,5
Indian Ocean,3,0,0,3,5
Indians,0,1,0,1,5
Ireland,1,0,4,5,5
JEANNE MOOS,0,0,1,1,5
Jeff Bezos,0,1,1,2,5
Jeff Zucker,0,2,1,3,5
Jerry Seinfeld,0,2,2,4,5
Jimmy Fallon,0,2,1,3,5
John Virgin,0,0,1,1,5
Jordan,0,0,3,3,5
Joseph Stiglitz,1,0,0,1,5
Juan Carlos Gutiérrez,1,0,1,2,5
Juan Manuel Santos,0,0,2,2,5
June,2,1,2,5,5
Kellyanne Conway,0,1,1,2,5
Kremlin,1,1,1,3,5
Larry Noble,0,1,0,1,5
Lincoln,1,1,0,2,5
Madagascar,1,0,0,1,5
Maggie Hassan,0,0,1,1,5
Majority Leader,1,4,0,5,5
Make America,0,3,0,3,5
Malia Obama,0,1,0,1,5
Malian,4,0,0,4,5
Manu Raju,2,1,2,5,5
Marjan Ghassemi,1,0,0,1,5
Matt Egan,3,0,2,5,5
mayor,1,1,3,5,5
Mideast,0,3,0,3,5
Mike Williams,1,0,0,1,5
MPLA,1,0,0,1,5
Ms.,0,5,0,5,5
Naciones Unidas,0,1,1,2,5
Narendra Modi,2,0,2,4,5
National Security Council,2,0,1,3,5
New Zealand,1,0,3,4,5
Nigel Farage,0,1,0,1,5
North,0,0,3,3,5
الاتحاد الإفريقي,0,0,1,1,5
الملك,3,1,1,5,5
تيران,0,0,1,1,5
Office of Management and Budget,2,0,1,3,5
Officer,1,0,4,5,5
one day,1,1,3,5,5
Orlando police,1,0,1,2,5
Orlando Police Chief,1,0,0,1,5
Oscar López Rivera,1,0,1,2,5
Pacific,1,1,3,5,5
Pacific Ocean,2,1,0,3,5
Panamanian,1,0,0,1,5
Paolo Gentiloni,2,0,1,3,5
parliament,2,0,0,2,5
Patrick H. O'Connor,0,1,0,1,5
Planned Parenthood,0,3,0,3,5
Queen,1,2,2,5,5
Queen Elizabeth,0,1,2,3,5
Queens,0,3,0,3,5
Reino Unido,0,0,3,3,5
Richard Quest,2,0,0,2,5
señor,0,0,5,5,5
Sever,1,0,0,1,5
Shanara Mobley,1,0,1,2,5
Sheriff,2,0,3,5,5
Sinaloa Cartel,1,0,0,1,5
six years,1,1,2,4,5
Smithsonian,0,1,3,4,5
Sonny Perdue,0,2,0,2,5
Sotheby's,1,0,0,1,5
South Africans,0,1,0,1,5
Stanford University,1,1,0,2,5
Steve H. Hanke,0,0,1,1,5
Tal Kopan,1,0,4,5,5
Talladega College,0,1,0,1,5
three weeks,2,2,1,5,5
Time Warner Company,5,0,0,5,5
Tom Barrack,0,2,0,2,5
Toyota Motor,1,0,0,1,5
Treasury Department,0,0,3,3,5
Trudeau,1,0,0,1,5
"Tue January 17, 2017",0,0,5,5,5
U.K.,1,1,0,2,5
U.N.,1,0,3,4,5
Ucrania,0,0,2,2,5
Uruguay,0,0,4,4,5
venezolano,0,0,2,2,5
Vermont,2,2,0,4,5
Vice President Bush,1,0,0,1,5
Willie McCovey,0,1,0,1,5
World Economic Forum,0,3,1,4,5
World Trade Organization,1,0,2,3,5
Ya'akub Musa Abu Al-Qi'an,1,0,0,1,5
Yes,2,2,1,5,5
Adam Gruler,1,0,0,1,5
Alice Hamilton,1,0,0,1,5
Boeing Dreamliner,0,1,0,1,5
Brasserie Les Halles,2,3,0,5,5
Bureau of Labor Statistics,1,0,0,1,5
Claire McCaskill,0,1,0,1,5
Coast Guard,0,1,1,2,5
Cohen,0,1,0,1,5
Contemporary China,0,1,0,1,5
Corey Wallace,0,0,1,1,5
Cortesía Air Salvage,0,0,1,1,5
Denver,1,0,0,1,5
Dubai,2,0,0,2,5
Eagles,2,0,0,2,5
Elmer Huerta,0,0,1,1,5
Francesco Rocca,3,0,0,3,5
Gale Crater,0,1,0,1,5
"Galveston, Texas",2,0,1,3,5
Google Assistant,1,0,0,1,5
Gordon Ramsay,1,2,0,3,5
House of Fraser,2,0,0,2,5
Howard,0,0,1,1,5
ICE,1,1,0,2,5
iPhone 8 Plus,1,0,0,1,5
Isaac Yacouba Zida,1,0,0,1,5
Joint Comprehensive Plan of Action,0,0,1,1,5
K. Bryant Smalley,1,0,1,2,5
Kevin McCarthy,1,0,1,2,5
Kilauea,1,0,0,1,5
Laura Jelliffe-Pawlowski,0,1,0,1,5
Lloyd Decker,1,0,0,1,5
Mark Parker,1,0,0,1,5
Mars Hand Lens Imager,0,1,0,1,5
MBAs,2,0,0,2,5
Nathaniel Meyersohn,1,3,0,4,5
Novi Sad,0,1,0,1,5
تويتر,1,1,2,4,5
Oscar Mayer,0,1,0,1,5
Pakistan,2,1,2,5,5
Patrick Spence,0,0,1,1,5
PM,3,0,2,5,5
Rachel Swaby,1,0,0,1,5
Raul Labrador,0,1,0,1,5
República Bolivariana de Venezuela,0,0,1,1,5
Sandro Galea,0,0,2,2,5
second day,1,0,0,1,5
Thomas Le Berre,1,0,0,1,5
Thor,0,0,2,2,5
Tokyo,1,0,1,2,5
مجلس التنسيق السعودي,0,1,1,2,5
un año,1,0,2,3,5
US Centers for Disease Control and Prevention,3,0,0,3,5
Abruzzo,2,0,0,2,4
Air Force,2,0,2,4,4
American Civil Liberties Union,0,0,2,2,4
American dream,0,2,2,4,4
Asia-Pacific,0,1,2,3,4
attorneys general,2,0,2,4,4
Axe Files,0,1,0,1,4
Ben Rhodes,0,2,0,2,4
Bo,0,2,0,2,4
Boston,2,0,2,4,4
Brad Sewell,1,0,0,1,4
Britain Israel Communications and Research Centre,0,1,0,1,4
Canadians,0,1,0,1,4
Carlos Slim,0,0,1,1,4
Carlton Philadelphia,0,0,2,2,4
Carol Costello,0,1,0,1,4
Centros,1,1,2,4,4
Charles Riley,0,1,2,3,4
chief executive,0,0,4,4,4
Chris Christie,0,1,0,1,4
Chris Isidore,0,2,2,4,4
Civil Protection Department,0,2,0,2,4
Clementa Pinckney,0,2,0,2,4
Clinton,0,2,1,3,4
CNN Worldwide,0,0,1,1,4
Commerce Department,1,0,1,2,4
commerce secretary,1,3,0,4,4
Congreso,0,1,2,3,4
Connecticut,2,1,1,4,4
Consejo Nacional Electoral,0,0,1,1,4
Consumer Financial Protection Bureau,1,0,0,1,4
David Winters,0,1,0,1,4
defense secretary,0,4,0,4,4
Denmark,2,1,1,4,4
Dennis McGuire,2,0,0,2,4
directora,1,2,1,4,4
Donaldo Barros,0,0,1,1,4
Dow,0,2,1,3,4
Economic Community of West African States,2,0,0,2,4
Eliza,1,0,0,1,4
embajador,0,0,4,4,4
Etah district,1,0,0,1,4
European continent,0,1,0,1,4
FB,0,1,2,3,4
First Lady,0,3,1,4,4
first year,1,1,1,3,4
Forbes,0,2,0,2,4
Foreign Minister,1,2,1,4,4
Fort Lauderdale-Hollywood International Airport,0,0,1,1,4
G-20,0,0,2,2,4
Gavin Schmidt,0,0,2,2,4
Gilad Erdan,1,0,0,1,4
GM,0,1,1,2,4
Gran Sasso,2,0,0,2,4
guatemalteco,1,0,0,1,4
Hampton University,0,0,1,1,4
Hiroshima,0,2,0,2,4
HSBC,1,0,1,2,4
Igor Shuvalov,0,0,1,1,4
Illinois,1,0,2,3,4
Interstate 610,1,0,1,2,4
Iowa,1,1,2,4,4
Irish,2,0,2,4,4
Islamic,2,2,0,4,4
Italia,0,1,0,1,4
IVF,1,0,0,1,4
Jackie Wattles,0,1,3,4,4
Jalal Maleki,0,0,1,1,4
Jameis Slaughter,1,0,0,1,4
James Hansen,0,0,2,2,4
Jason Hanna,3,1,0,4,4
Javier Duarte,0,0,1,1,4
Jimmy Carter,0,2,0,2,4
JPMorgan Chase,0,0,2,2,4
Judith Vonberg,0,0,3,3,4
juez,1,1,2,4,4
Kansas,0,0,3,3,4
Kanye West,0,3,0,3,4
"Kingston, Jamaica",0,0,2,2,4
Lee Friedman,1,0,0,1,4
Lee Jae,0,1,0,1,4
Lei Chen,0,0,1,1,4
Lou,1,0,0,1,4
Louisiana,0,2,2,4,4
Malaysia,1,0,1,2,4
Martin Luther King,0,1,0,1,4
Matthew Dowd,1,0,0,1,4
Mauricio Macri,1,0,1,2,4
Mayor,2,0,2,4,4
Miami Metrozoo,0,1,0,1,4
Michael Mann,0,2,0,2,4
Michigan Humane Society,1,0,0,1,4
Miguel Ángel Yunes Linares,0,0,1,1,4
Mike Enzi,1,0,1,2,4
Ministerio Público,0,0,1,1,4
Mitch McConnell,0,4,0,4,4
NASA Goddard Institute for Space Studies,0,2,0,2,4
Nate Tamarin,0,2,0,2,4
Netanyahu,3,0,0,3,4
Nevada,1,0,1,2,4
New York Times,2,1,1,4,4
Nicholas Tamarin,0,0,2,2,4
Nielsen,2,0,0,2,4
Nina Pham,2,0,0,2,4
Nor,1,0,0,1,4
North America,1,2,1,4,4
Nuevo León,2,0,1,3,4
رئيس,2,2,0,4,4
السعودية,1,1,1,3,4
المصري,2,1,0,3,4
"Oakland, California",1,2,0,3,4
Office of Governmental Ethics,2,0,0,2,4
Oficina Oval,0,0,2,2,4
Ontario,2,0,1,3,4
Orlando gay nightclub,0,0,1,1,4
Paul R. La Monica,0,3,1,4,4
Paul Ryan's,0,1,0,1,4
Pensilvania,1,1,0,2,4
Percy Nayokpuk,2,0,0,2,4
Pete Buttigieg,0,1,0,1,4
primera dama,0,4,0,4,4
Prince Philip,0,0,2,2,4
Pulse nightclub,2,0,0,2,4
Raul Castro,0,2,0,2,4
Red Cross,2,0,0,2,4
Richard Roth,1,2,1,4,4
Richmond,2,0,0,2,4
Ruby,0,0,2,2,4
Russians,2,1,0,3,4
Servicio Geológico de Estados Unidos,2,0,0,2,4
Sgt.,0,2,2,4,4
Sisi,1,1,0,2,4
Smithsonian Institution,0,2,0,2,4
Sony,1,1,0,2,4
South Koreans,1,0,3,4,4
St. Louis,3,0,1,4,4
Starbucks,2,0,1,3,4
Stella,2,0,0,2,4
Sterling K. Brown,0,1,1,2,4
Stonehenge,0,2,0,2,4
Tehran Emergency Services,2,0,0,2,4
Tel Aviv,0,0,4,4,4
The Times,1,2,0,3,4
third year,0,0,2,2,4
This Is Us,0,1,0,1,4
Tom Ford,0,0,1,1,4
Toronto,0,0,2,2,4
treasury secretary,0,3,1,4,4
two weeks,1,1,2,4,4
un mes,2,0,1,3,4
UN Security Council Washington,2,0,0,2,4
UNITA,0,0,1,1,4
United Nations Samantha Power,2,0,0,2,4
United Nations Security Council,0,0,2,2,4
Univision,0,1,0,1,4
US Justice Department,0,2,0,2,4
US Senate,2,0,1,3,4
US Treasury Department,2,0,0,2,4
Vietnam,1,3,0,4,4
Virginia McLaurin,0,2,0,2,4
Wade,2,0,0,2,4
Washington D.C.,1,2,1,4,4
West Bank,1,0,2,3,4
WJXT,1,0,2,3,4
Yiwu,1,0,0,1,4
Young Roger Clemens,0,1,0,1,4
YouTube,0,0,4,4,4
AI,0,1,0,1,4
Alice Catherine Evans,0,1,0,1,4
Anna Beninger,0,1,0,1,4
Augustín Garza,0,1,0,1,4
Barbara Underwood,1,0,0,1,4
Belgrade,0,1,0,1,4
Camilo Egaña,0,0,1,1,4
ChemCam,0,1,0,1,4
Chris Gowen,1,0,0,1,4
Chrystia Freeland,1,1,0,2,4
Cliff Kincaid,0,1,0,1,4
CNN International,1,0,1,2,4
Colegio de México,1,0,0,1,4
Congreso de Perú,0,0,1,1,4
Congressional Budget Office,2,0,0,2,4
CONRED,2,0,0,2,4
Consejo de Ministras,0,0,1,1,4
Corey Lewandowski,0,1,0,1,4
David Williams,2,0,1,3,4
Debbie,0,1,0,1,4
Delcianna Winders,0,1,0,1,4
Denham,0,1,0,1,4
departamento de Antioquia,2,0,0,2,4
Dolores O'Riordan,1,0,0,1,4
Doug Pederson,0,0,1,1,4
Dover,1,0,0,1,4
Edwin,0,1,0,1,4
Eric Ripert,0,0,1,1,4
Escuintla,0,1,0,1,4
Esporte Interativo,0,1,0,1,4
EUR,1,1,0,2,4
executive chef,0,2,2,4,4
Federal Bureau of Investigation,1,0,0,1,4
five days,1,2,1,4,4
Francho Barón,1,0,1,2,4
Frank Gaffney,1,0,0,1,4
Frith Street Gallery,0,0,1,1,4
Gayle Brandeis,0,1,0,1,4
George R. Brown Convention Center,0,1,1,2,4
Georgia Composite Medical Board,1,0,0,1,4
Gerasimov,0,1,0,1,4
Gobierno de España,0,1,0,1,4
Guangzhou,1,0,0,1,4
Guatemalan,2,0,0,2,4
Hanoi,0,2,0,2,4
Harry Enten,1,0,1,2,4
Harvey Weinstein,0,2,0,2,4
Honeywell,1,0,0,1,4
IFRC,1,0,0,1,4
Immigration and Customs Enforcement,1,0,0,1,4
Jack Dorsey,1,0,2,3,4
Jack Goldsmith,0,1,0,1,4
Jefferies,1,0,0,1,4
Jeremy Douglas,0,1,0,1,4
Josué,1,0,0,1,4
Judy Garland,0,1,1,2,4
Kim Yo Jong,0,0,2,2,4
Kim Yong Chol,0,2,0,2,4
Lago Verde,0,1,0,1,4
LeBron,2,2,0,4,4
Lenin,0,1,0,1,4
manager,0,1,3,4,4
Mark Inglis,1,0,0,1,4
Mel Bower,2,0,0,2,4
Michael Dunavant,0,1,0,1,4
Mira Moufarrej,0,1,0,1,4
Missouri,1,0,0,1,4
MS-13,1,0,0,1,4
National Geographic,0,0,2,2,4
New York State,0,0,1,1,4
No Reservations,2,2,0,4,4
Noelle Younge,0,0,1,1,4
North Koreans,1,1,0,2,4
Northeast,0,0,4,4,4
Northern Ireland Human Rights Commission,1,0,0,1,4
NPR,0,2,0,2,4
روبرت مارديني,0,1,0,1,4
تيم أوبرايان,0,0,1,1,4
Orlando nightclub,0,0,1,1,4
papa Francisco,0,0,1,1,4
Peabody Award,0,2,0,2,4
Pirelli,0,1,0,1,4
Plannck II Columbus,0,0,1,1,4
Prime Minister Trudeau,0,1,0,1,4
primer ministro,0,0,4,4,4
Prince George's County,1,0,0,1,4
Rob Portman,0,0,1,1,4
Robert Spencer,1,0,0,1,4
sábado 9 de junio,0,1,0,1,4
Sally Yates,1,0,0,1,4
San Miguel,0,0,2,2,4
Senate Majority PAC,1,0,0,1,4
Shutterstock,1,0,1,2,4
Télam,0,0,1,1,4
Tim O'Brien,1,0,0,1,4
Travel Channel,3,0,0,3,4
two hours,2,0,1,3,4
UNE,2,0,0,2,4
United States Department of Defense,1,0,0,1,4
US government,2,0,0,2,4
US sanctions,3,0,1,4,4
Vacationland,0,0,1,1,4
Vassar College,0,0,4,4,4
Vaticano,0,1,1,2,4
Wiesbaden,1,0,0,1,4
Xavier Becerra,0,1,0,1,4
Xi'an Famous Foods,0,2,0,2,4
Zawiya refinery,0,1,0,1,4
Abigail Brenner,0,0,1,1,3
AC360,1,1,1,3,3
actress,1,0,2,3,3
Administración Nacional Oceánica y Atmosférica Este,1,0,0,1,3
Aiken,1,0,0,1,3
Al Franken,0,0,1,1,3
Al Mourabitoun,1,0,1,2,3
Alan Johnson,0,0,1,1,3
Alex Kallen,0,0,1,1,3
Alibaba,1,1,0,2,3
América Latina,3,0,0,3,3
América Móvil,0,0,1,1,3
Andrei Lankov,0,0,1,1,3
Arab,1,1,1,3,3
Arturo Sirgo,0,0,1,1,3
Astros,0,2,0,2,3
Australian,1,1,0,2,3
Axios,0,3,0,3,3
"Baja, Mexico",0,1,1,2,3
Baltimore,0,0,3,3,3
Banjul International Airport,3,0,0,3,3
Barbara Starr,0,1,2,3,3
Bill Gross,0,1,0,1,3
Bonior,0,0,1,1,3
Brooke Brower,0,2,1,3,3
Brooklyn,1,1,1,3,3
Brussels,1,1,1,3,3
Bureau of Land Management,1,0,0,1,3
cabinet,0,1,1,2,3
Cancún,1,0,0,1,3
Capitolio,0,0,1,1,3
CARL AZUZ,1,0,0,1,3
Carla Fajardo,1,0,0,1,3
Central Intelligence Agency,1,0,0,1,3
Chair,1,2,0,3,3
China Railway,1,0,0,1,3
Chuck Grassley,1,0,0,1,3
Clínica Universidad de Navarra,0,0,1,1,3
Commerce secretary,2,1,0,3,3
Conservative party,0,1,0,1,3
"Cook County, Illinois",1,0,0,1,3
Corolla,0,0,1,1,3
country director,0,1,2,3,3
cuatro años,1,1,0,2,3
Cuomo,0,2,1,3,3
David Litt,0,1,0,1,3
David Shortell,2,0,1,3,3
Delta,1,0,1,2,3
Departamento de Bomberos,0,0,2,2,3
Devon Energy,0,0,1,1,3
Dick Cheney,0,2,1,3,3
District of Columbia,0,0,2,2,3
Distrito de Columbia,0,1,1,2,3
Dodd-Frank,1,0,0,1,3
dos años,1,0,2,3,3
Dylan Byers,0,1,1,2,3
Education Secretary,0,2,1,3,3
education secretary,1,2,0,3,3
education secretary nominee,0,1,2,3,3
Egypt,1,1,0,2,3
Eisenhower Executive Office Building,3,0,0,3,3
Elijah Cummings,0,0,1,1,3
Emory University School of Medicine,1,0,2,3,3
English,0,1,2,3,3
Eric Bradner,1,1,1,3,3
Erin Burnett,1,0,1,2,3
Erin Burnett OutFront,0,3,0,3,3
Esquire,2,0,0,2,3
exgobernador,1,0,2,3,3
exvicepresidente,0,0,3,3,3
FARC,0,1,0,1,3
febrero de 2014,0,0,2,2,3
Federal Reserve,0,1,2,3,3
Fifth Avenue Presbyterian Church,0,1,0,1,3
Focus on the Family,0,0,1,1,3
Fondo Monetario Internacional,0,0,2,2,3
Foreign Ministry,1,2,0,3,3
"Fort Pierce, Florida",0,0,1,1,3
founder,0,1,2,3,3
four decades,0,2,1,3,3
Francois Delattre,1,1,0,2,3
Frank Sinatra,0,1,0,1,3
"Fri January 20, 2017",0,0,3,3,3
Ghana,0,0,3,3,3
Grand Mac,0,1,0,1,3
Haim Saban,0,1,0,1,3
Hall of Fame,1,0,0,1,3
Hank Aaron,1,0,0,1,3
Harold Hamm,0,0,1,1,3
Harvard University,0,0,3,3,3
HHS,1,1,0,2,3
Hit Trump,0,0,1,1,3
Holanda,0,0,3,3,3
Hossein Hashemi,3,0,0,3,3
Hura,1,0,0,1,3
ICBM,1,0,0,1,3
Inauguration Day,0,2,0,2,3
Indianapolis,1,0,1,2,3
Indo-Pakistan,0,1,0,1,3
Inga Beale,0,0,1,1,3
Irán,0,0,1,1,3
iraní,0,0,1,1,3
Iván Rodríguez,0,0,1,1,3
Jack Ma,0,0,1,1,3
Jacksonville,0,0,3,3,3
"Jacksonville, Florida",0,0,3,3,3
Jake Tapper,1,1,1,3,3
James Chao,0,0,1,1,3
jefe de Estado,0,1,2,3,3
Jerusalem,1,1,0,2,3
Johannesburg,0,2,1,3,3
Justice and Development Party,0,0,1,1,3
"La Jolla, California",0,2,1,3,3
Lago resort,0,1,0,1,3
Larry Page,0,0,3,3,3
Las Vegas,0,1,2,3,3
last July,2,0,1,3,3
last September,1,2,0,3,3
Latin American,3,0,0,3,3
Latino,1,0,2,3,3
Latinos,1,0,0,1,3
Laura Jarrett,1,0,2,3,3
Lee,0,1,2,3,3
Levi,0,0,1,1,3
Lincoln Memorial,0,1,1,2,3
Lisa Madigan,1,0,0,1,3
Londres,0,2,1,3,3
Lt.,1,0,2,3,3
Maayan,1,0,0,1,3
Mac Jr.,0,1,0,1,3
Madrid,2,0,0,2,3
Maeve Reston,1,0,2,3,3
Malaysian,0,1,0,1,3
Marie Crandall,1,0,0,1,3
Marine Gen.,0,2,1,3,3
Mary,0,1,1,2,3
Medicare,0,1,1,2,3
Megan Mullally,0,1,0,1,3
Met Office,1,0,2,3,3
Michael Jackson,0,0,1,1,3
Milo Ventimiglia,0,1,1,2,3
minister,0,2,1,3,3
ministers,2,0,1,3,3
Mojtaba Doroodian,0,1,2,3,3
Montana,0,3,0,3,3
Monterrey,0,0,2,2,3
Nadine Heredia,0,0,1,1,3
Nancy Pelosi,2,1,0,3,3
National Archives,2,0,0,2,3
National Security Adviser,0,0,3,3,3
Negev Desert,1,0,0,1,3
Nelson Mandela,0,0,3,3,3
Netherlands,0,0,3,3,3
New Hampshire,1,0,2,3,3
New Orleans,1,2,0,3,3
North America Free Trade Agreement,1,0,0,1,3
إدريس لكريني,1,0,0,1,3
البرلمان,1,1,0,2,3
عبد الرحيم العلام,0,0,1,1,3
عصام الإسلامبولي,1,0,0,1,3
octubre,2,0,1,3,3
Office,1,0,2,3,3
Oman,2,0,1,3,3
ORC,0,1,1,2,3
Oscar Lopez Rivera,0,1,0,1,3
Palumbos,0,0,1,1,3
Panama City,1,0,0,1,3
Parkinson,1,0,1,2,3
Patrick Gillespie,0,1,1,2,3
Paula White,0,1,0,1,3
Pawnee,1,0,0,1,3
Pearson,1,1,0,2,3
People's Choice Awards,0,1,0,1,3
Pham,0,2,1,3,3
Phil Mudd,1,0,0,1,3
Pope,0,1,2,3,3
Portugal,0,0,1,1,3
President Bush,2,0,0,2,3
President John Kennedy,1,0,0,1,3
president-elect,1,2,0,3,3
Professor,0,0,3,3,3
Quintana Roo,0,1,0,1,3
Rahm Emanuel,1,0,2,3,3
RBI,1,0,0,1,3
Reno,1,0,0,1,3
Republican Attorneys General Association,0,1,0,1,3
Rev.,0,0,3,3,3
Rihanna,0,1,1,2,3
Robinson,0,1,0,1,3
Roe,2,0,0,2,3
Roger Handberg,0,0,1,1,3
Ross Levitt,0,2,1,3,3
Sábado,0,1,0,1,3
Sánchez,0,0,1,1,3
Sandra Gonzalez,0,2,1,3,3
Santiago,0,0,1,1,3
Scotland,1,0,2,3,3
secretary general,2,0,1,3,3
Secretary-General,2,0,1,3,3
seis meses,1,0,1,2,3
Selma,0,1,0,1,3
Senate Budget Committee,1,1,0,2,3
Senate confirmation,0,1,2,3,3
Senate Finance Committee,2,0,1,3,3
septiembre,1,0,1,2,3
seven-year,3,0,0,3,3
Shark Tank,0,0,1,1,3
Sherisse,0,2,1,3,3
Sierra Club,1,0,0,1,3
six weeks,1,1,1,3,3
six-day,0,0,3,3,3
Small Business Administration,0,0,1,1,3
Sony/ATV,0,0,1,1,3
Sophie Tatum,1,0,2,3,3
Soviet Union,1,1,0,2,3
Studio 54,0,1,0,1,3
Summers,1,0,0,1,3
Susan Rice,1,0,0,1,3
Swiss Confederation,0,1,0,1,3
Syrian,0,2,1,3,3
Taiwan,0,1,1,2,3
The Huffington Post,0,1,2,3,3
Theodore Schleifer,1,1,1,3,3
Thomas Cook,3,0,0,3,3
Thomas Jefferson,0,0,3,3,3
three hours,2,1,0,3,3
Three months,1,1,0,2,3
three months,1,0,0,1,3
Times of London,0,1,0,1,3
Togo,0,0,3,3,3
Tom Perez,0,1,0,1,3
tres años,1,0,1,2,3
Trump Organization,0,2,0,2,3
Two years,2,0,1,3,3
U.N. organization,0,1,0,1,3
UN Security Council,1,0,1,2,3
United Airlines,1,2,0,3,3
Urban Development,0,0,2,2,3
US Capitol,0,1,0,1,3
Uttar Pradesh,0,0,1,1,3
Valerie Jarrett,1,0,2,3,3
Vicqui Lee,0,0,1,1,3
Vyvyan Evans,0,0,1,1,3
Wade Payson-Denney,0,0,3,3,3
Walter Russell Mead,0,1,0,1,3
"Walterboro, South Carolina",1,0,1,2,3
Wapiti School,0,0,1,1,3
West Africa,1,0,1,2,3
White House Oval Office,0,0,3,3,3
White House press briefing,2,1,0,3,3
Wikileaks,0,1,0,1,3
William Lynch,0,1,0,1,3
Wolf Blitzer,0,2,1,3,3
Yankees,0,2,0,2,3
Yongbyon,3,0,0,3,3
Zarit,1,1,0,2,3
Zukin,0,0,1,1,3
Adidas,0,0,1,1,3
Afghan government,0,1,0,1,3
Airbus,0,1,1,2,3
Alain Lejeune,0,1,0,1,3
Alex Azar,0,1,0,1,3
Alternative for Germany,1,0,0,1,3
Anderson Cooper 360,0,3,0,3,3
Andrew McCabe,1,0,1,2,3
Andromachi Athanasopoulou,0,1,0,1,3
Arunima Sinha,0,0,1,1,3
Ashraf Ghani,0,1,0,1,3
Avril Wu,1,0,0,1,3
"Baa Atoll, Maldives",1,0,0,1,3
Barbara Bush,1,0,0,1,3
Barbara McClintock,0,1,0,1,3
Barbara Rosini,0,0,1,1,3
Barcelona,1,0,1,2,3
Befrienders Worldwide,0,3,0,3,3
"Belmont Park, New York",0,0,1,1,3
Bentley,0,1,0,1,3
Big Island,0,0,2,2,3
Bogotá,1,0,0,1,3
Bonhams,1,0,0,1,3
Brian Stelter,3,0,0,3,3
BuzzFeed News,0,1,0,1,3
Caracas,1,0,0,1,3
Center for Security Policy,1,0,0,1,3
Chien-Shiung Wu,0,1,0,1,3
Christopher Nolan,1,0,0,1,3
Christopher Wray,0,1,0,1,3
Chubb,0,0,1,1,3
Colorado,0,0,1,1,3
Compassion & Choices,0,1,0,1,3
Consejo de Ministras y Ministros,0,1,0,1,3
Conway,1,0,0,1,3
Corey Stewart,1,0,0,1,3
Culture Minister,1,0,2,3,3
Curiosity Mars,1,0,0,1,3
Cut It,0,0,1,1,3
Dan DeLoach,1,0,0,1,3
David McQueen,0,1,0,1,3
David Scott Holloway,0,0,1,1,3
David Solomon,0,0,2,2,3
Deloitte,1,0,1,2,3
Democratic Congressional Campaign Committee,0,0,2,2,3
Democratic Unionist Party,0,1,0,1,3
Deputy Attorney General,2,1,0,3,3
Dermot Shea,1,0,1,2,3
Devin Nunes,0,3,0,3,3
Donna Raney,1,0,0,1,3
Dwight Clark,1,0,0,1,3
Elsie Widdowson,0,0,1,1,3
Emmanuel Macron,0,3,0,3,3
Faith Karimi,2,1,0,3,3
first six months,0,1,2,3,3
Four Seasons Landaa Giraavaru,0,1,0,1,3
four-year,0,2,1,3,3
Freedom Caucus,1,0,0,1,3
Freedom of Information Act,0,0,1,1,3
G-7,1,1,0,2,3
Gaza Responding,1,0,0,1,3
GoFundMe,0,1,1,2,3
Grace Murray Hopper,0,1,0,1,3
GTO,0,1,0,1,3
Haagen-Dazs,0,1,0,1,3
Hamas,1,0,0,1,3
Harry Anderson,1,0,0,1,3
Heather Byrne,1,0,0,1,3
Henry Harteveldt,0,0,1,1,3
House Judiciary Committee,2,0,0,2,3
I.Sat,1,0,0,1,3
Icilma Cornelius,1,0,0,1,3
Inés Zorreguieta,1,0,0,1,3
Indonesia,0,0,2,2,3
Inspector General,2,1,0,3,3
International Association for Suicide Prevention,0,3,0,3,3
International Organization for Migration,1,0,0,1,3
Ivan Cabrera,3,0,0,3,3
Ivana Kottasová,2,1,0,3,3
Jack) Lew,1,0,0,1,3
James Gleeson,0,0,1,1,3
Janice Forse,1,0,0,1,3
Jarrett Blanc,1,0,0,1,3
Jenny Zenner,0,1,0,1,3
Jim Kauahikaua,0,0,2,2,3
Joe Manchin,0,0,1,1,3
Jonathan Hafetz,1,0,0,1,3
Joseph S. Bermudez Jr.,0,1,0,1,3
Josh Harris,0,0,1,1,3
Junko Tabei,0,0,1,1,3
"Kabul, Afghanistan",0,0,1,1,3
Kapoho Bay,1,0,0,1,3
Keith Jackson,1,0,0,1,3
Kelly Sadler,0,1,0,1,3
Kim family,1,0,0,1,3
Korea,0,3,0,3,3
Korean Central News Agency,0,0,1,1,3
Korean Peninsula,0,3,0,3,3
Kyle Plotkin,1,0,0,1,3
Kyoto,1,1,1,3,3
"Lagos, Nigeria",1,0,1,2,3
Latoyah Rideau,1,0,0,1,3
LEE,1,1,1,3,3
LGBTQ Victory Fund,0,1,0,1,3
London Fire Brigade,0,1,0,1,3
Los Lotes,0,0,1,1,3
Máxima de Holanda,0,0,2,2,3
Mediterranean,0,1,0,1,3
Memento,1,0,0,1,3
Michelle Kosinski,0,1,2,3,3
Monica Lewinsky,1,0,0,1,3
MTN,1,0,0,1,3
Mueller,2,0,0,2,3
Néstor Humberto Martínez,0,0,1,1,3
National Suicide Prevention Lifeline,0,3,0,3,3
Navigation Camera,0,0,1,1,3
NBA,2,1,0,3,3
NBC News,0,1,1,2,3
Nepalese,0,0,1,1,3
New York Police Department,2,0,0,2,3
New Yorker,0,2,1,3,3
بلاك توميتو,1,0,0,1,3
أحمد خالد موسى,0,1,0,1,3
الأردن,1,1,0,2,3
الأمريكي,0,0,1,1,3
الإماراتي,0,1,1,2,3
الاماراتي,0,1,0,1,3
الصدر,1,0,0,1,3
الصليب الأحمر,1,0,0,1,3
العراقي,0,0,1,1,3
العراقية,2,0,0,2,3
السورية,0,0,1,1,3
المهندس,2,1,0,3,3
الياباني,1,0,0,1,3
عبد الفتاح السيسي,0,1,0,1,3
تايم,0,1,0,1,3
Obama Administration,1,0,1,2,3
octubre de 2019,1,0,0,1,3
Office of Inspector General,1,0,0,1,3
Ouagadougou,0,0,1,1,3
Pedro Sánchez,0,1,0,1,3
Pence,0,1,1,2,3
Peter O'Rourke,0,0,1,1,3
Peter Strzok,1,0,0,1,3
Philadelphia 76ers,1,0,0,1,3
Port Arthur,1,0,0,1,3
Quebec,2,0,0,2,3
Quinnipiac University poll,1,1,0,2,3
Recorded Future,0,0,1,1,3
Rob Porter,1,0,0,1,3
Rob Vito,1,0,0,1,3
Rod Rosenstein,2,0,0,2,3
Royal Academy,0,0,1,1,3
Rupert Murdoch,1,0,0,1,3
Ryan Costello,1,0,0,1,3
Samantha Bee,2,0,0,2,3
Samsung,1,1,1,3,3
Sandra Bullock,0,0,1,1,3
Saudi,1,0,1,2,3
Semar,1,0,0,1,3
Senate Select Committee on Intelligence,1,1,0,2,3
Square,0,0,1,1,3
Sri Lanka,0,0,3,3,3
Stalin,1,0,0,1,3
Steve Almasy,2,0,1,3,3
Tarmac Aerosave,0,0,1,1,3
TCL,0,1,0,1,3
Ted Allen,3,0,0,3,3
Tencent,0,1,1,2,3
The Oprah Winfrey Show,0,0,1,1,3
Tisza,1,0,0,1,3
TNT,0,1,0,1,3
TNT Sports,0,1,1,2,3
Trabant,0,1,0,1,3
Trump-Kim,1,1,0,2,3
TruTV,1,0,0,1,3
Tu-144,1,0,0,1,3
Turner Latin America,0,0,1,1,3
ولي عهد,2,1,0,3,3
فتحي عبد الوهاب,1,0,0,1,3
Under Armour,1,0,0,1,3
United Nations Office on Drugs and Crime,0,1,0,1,3
US intelligence community,2,1,0,3,3
US Treasury,0,2,1,3,3
يومين,1,2,0,3,3
Verne Troyer,1,0,0,1,3
Veronica Stracqualursi,0,0,3,3,3
Villavicencio,0,1,0,1,3
Wall Street Journal,1,0,0,1,3
Washington Capitals,1,0,0,1,3
writer,0,0,3,3,3
WSJ,0,1,0,1,3
Xiaomi,1,0,1,2,3
Yasumasa Kuroda,1,0,0,1,3
Abraham Lincoln,0,2,0,2,2
Abuja,0,0,2,2,2
Adalah,0,0,1,1,2
Adel Abdel Ghafar,0,1,0,1,2
Afganistán,0,0,1,1,2
AFI,0,2,0,2,2
agosto,1,0,1,2,2
agosto de 2014,0,0,1,1,2
Ahiza Garcia,1,1,0,2,2
AJ Willingham,1,1,0,2,2
Aldo Fasci,0,0,2,2,2
Alejandro García Pinilla,0,1,0,1,2
alemana,0,1,0,1,2
Alessandro Giancaterino,2,0,0,2,2
Algerian,0,2,0,2,2
Almut Möller,0,1,0,1,2
Alpha Jets,0,2,0,2,2
Al-Shabaab,0,0,2,2,2
Amazing Grace,0,2,0,2,2
Amber Vinson,0,0,2,2,2
American Psychiatric Association,1,0,1,2,2
Amy Pope,1,0,0,1,2
analyst,1,0,1,2,2
Andrew Kaczynski,1,0,1,2,2
Andrew W. Mellon,0,0,1,1,2
Andy Puzder,1,0,0,1,2
Andy Warhol,0,1,1,2,2
Angela Dewan,0,0,2,2,2
Anja Reserve,0,1,0,1,2
Ann Kirkpatrick,0,0,2,2,2
Annie Weyiouanna,0,0,2,2,2
Antarctic,2,0,0,2,2
Anthony Scaramucci,2,0,0,2,2
Arctic Circle,2,0,0,2,2
Army Radio,0,0,1,1,2
Army Ranger,2,0,0,2,2
Art Grani,0,1,0,1,2
Ashleigh Banfield,0,2,0,2,2
Ashley Baskerville,0,2,0,2,2
Ashley Judd,1,0,0,1,2
Assad regime,0,0,2,2,2
assistant professor,2,0,0,2,2
Atlantic,0,0,2,2,2
Attorneys General,1,0,1,2,2
Austin,1,0,1,2,2
"Austin, Texas",0,0,2,2,2
Australian Transport Safety Bureau,1,0,0,1,2
Austria,1,1,0,2,2
Barbie Nadeau,0,0,2,2,2
Baskerville-Tucker,2,0,0,2,2
Bavarian Alps,0,0,2,2,2
Beirut,0,1,1,2,2
Belgium,0,1,1,2,2
"Bethesda, Maryland",0,2,0,2,2
Betsy Klein,1,0,0,1,2
Bible,0,1,0,1,2
Bijan Hosseini,0,2,0,2,2
Bloomberg,1,0,1,2,2
Bonzi Mathuri,2,0,0,2,2
Borno,2,0,0,2,2
Brandenburg Gate,0,1,1,2,2
Breitbart News Media,0,1,0,1,2
Brian,0,2,0,2,2
Brian Lowry,0,0,2,2,2
Brunner,0,1,0,1,2
Buchenwald Memorial,0,0,2,2,2
budget director,2,0,0,2,2
Bush padre,0,0,1,1,2
Bush-Cheney,0,1,0,1,2
Cairo University,0,2,0,2,2
Cameroon,0,0,2,2,2
captain,2,0,0,2,2
Cartwright,0,2,0,2,2
Catherine,0,2,0,2,2
Cayman Islands,1,0,0,1,2
CBS,1,1,0,2,2
Centers for Disease Control and Prevention,1,0,1,2,2
Chad,0,0,2,2,2
chair,0,0,2,2,2
chairwoman,0,2,0,2,2
Charles Manigo,0,0,1,1,2
"Charleston, South Carolina",2,0,0,2,2
Chase Strangio,0,0,2,2,2
Chibok,2,0,0,2,2
Chicago White Sox,0,0,1,1,2
chief commercial officer,0,0,2,2,2
chief executive officer,0,0,2,2,2
Chief of Staff,0,0,2,2,2
chief speechwriter,0,0,2,2,2
Cho Eui-yeon,1,0,0,1,2
Choice TV,0,2,0,2,2
Chrisley Knows Best,0,1,0,1,2
Chrissy Metz,0,1,1,2,2
Christ the Redeemer,0,0,2,2,2
Christianity,0,1,0,1,2
CICIG,0,0,1,1,2
CIT Group,0,0,1,1,2
Ciudad de Guatemala,0,0,1,1,2
Clara Kokeok,2,0,0,2,2
Clean Power Plan,0,1,0,1,2
Clemens,1,0,0,1,2
Cleveland State University,0,0,2,2,2
CNNMoney (New York,0,0,2,2,2
Cody Keenan,0,0,1,1,2
Colegio Americano,0,1,1,2,2
Colegio Americano del Noreste,1,0,0,1,2
colonel,1,0,1,2,2
Coloradas de la Virgen,2,0,0,2,2
Comedian,0,0,2,2,2
Comité Internacional de la Cruz Roja,1,0,0,1,2
Commerce nominee,2,0,0,2,2
Commission,2,0,0,2,2
commissioner,0,2,0,2,2
Conservative Party,0,1,0,1,2
"Cooperstown, New York",0,1,0,1,2
Coordination of Movements of Azawad,0,2,0,2,2
Corea del Sur,1,0,0,1,2
Corvette Stingray,0,0,2,2,2
Cuban,0,0,2,2,2
Dale R. Griffin,0,2,0,2,2
Dan Fogelman,0,1,0,1,2
Dan Merica,1,0,1,2,2
Dana Murphy,0,1,0,1,2
Danish,0,0,2,2,2
Darran Simon,1,0,0,1,2
Darren Wilson,2,0,0,2,2
Dave Alsup,0,0,2,2,2
"Dearborn, Michigan",0,2,0,2,2
Deborah Bloom,0,0,2,2,2
Deborah Clayton,1,0,0,1,2
Debra Messing,0,1,0,1,2
Dennis Ross,0,0,1,1,2
Department of Defense and Department of Homeland Security,0,1,0,1,2
Deputy National Security Advisor,0,0,2,2,2
deputy press secretary,0,0,2,2,2
"Des Moines, Iowa",0,1,1,2,2
Detroit,0,0,2,2,2
Dick,0,1,1,2,2
Director of Legislative Affairs,0,0,2,2,2
directors,0,0,2,2,2
Dodge County,1,0,0,1,2
Donald) Trump,0,1,0,1,2
Dos meses,2,0,0,2,2
Doug Criss,0,0,2,2,2
Douglas Brinkley,0,1,1,2,2
"Dover, Delaware",0,0,2,2,2
Duchess of Cambridge,0,2,0,2,2
Eagle Road,1,0,0,1,2
Earth Science Center,2,0,0,2,2
ECMWF,0,0,2,2,2
Edgar,0,0,2,2,2
Edgar & Elsa Prince Foundation,0,0,1,1,2
Edmund Pettis Bridge,0,2,0,2,2
Education Department,0,1,1,2,2
El Chapo,1,0,0,1,2
El Nino,0,1,0,1,2
Election Day,2,0,0,2,2
Elhadj As Sy,2,0,0,2,2
Eli Watkins,1,0,1,2,2
Ella Rhodes,0,0,2,2,2
Ellie Kaufman,1,0,1,2,2
Eloise Palumbo,1,0,0,1,2
Emma Coronel Aispuro,0,0,1,1,2
Enda Kenny,0,0,2,2,2
Energy Secretary,0,0,2,2,2
enero de 2009,0,0,1,1,2
enero de 2015,0,0,1,1,2
England,0,0,2,2,2
envoy,0,1,1,2,2
Eric McCormack,0,1,0,1,2
Eric Schneiderman,1,1,0,2,2
Eric Schultz,0,0,1,1,2
Erika Guevara-Rosas,0,0,2,2,2
Ernesto Samper,0,0,1,1,2
Esquire Network,1,0,0,1,2
Etah,1,0,0,1,2
Euan McKirdy,1,0,1,2,2
Eurasia,1,0,1,2,2
European Council on Foreign Relations,0,2,0,2,2
Europeans,0,1,1,2,2
Europeos,1,0,0,1,2
Expansión,0,0,2,2,2
Farai Sevenzo,2,0,0,2,2
Farindola,0,0,2,2,2
Fars news agency,0,0,2,2,2
Father,0,0,2,2,2
Ferguson,2,0,0,2,2
"Ferguson, Missouri",2,0,0,2,2
Fernandez,2,0,0,2,2
first days,0,2,0,2,2
First Lady Melania Trump,1,0,0,1,2
first night,1,0,1,2,2
First Presbyterian Church in Jamaica,0,1,0,1,2
fiscal,0,0,2,2,2
Fisher Institute for Air and Space Strategic Studies,0,0,2,2,2
Five days,2,0,0,2,2
Food and Drug Administration,1,0,0,1,2
foreign minister,0,1,1,2,2
Foro Económico Mundial,1,0,1,2,2
Fort Leavenworth,0,0,1,1,2
four minutes,1,1,0,2,2
Frank Pallotta,0,1,1,2,2
Franklin Roosevelt,1,0,0,1,2
Fred Steeper,0,1,0,1,2
G-7 Summit,0,0,2,2,2
Gambians,1,0,0,1,2
Gamboa,1,0,0,1,2
Gao,2,0,0,2,2
GE,0,0,2,2,2
Geneva,0,0,2,2,2
George Mitchell,1,0,0,1,2
George VI,0,0,2,2,2
George W. Bush Presidential Center,0,0,2,2,2
Germans,0,1,0,1,2
Gilmore Girls,0,1,0,1,2
"Giza, Egypt",0,2,0,2,2
Gladys Anabella de León Ruiz,0,0,1,1,2
Glasgow Coma Score,1,0,0,1,2
GMA,0,1,0,1,2
God Bless the U.S.A.,0,1,0,1,2
Golden Globe,1,1,0,2,2
Goldman Environmental Foundation,0,0,2,2,2
Goree Island,2,0,0,2,2
Grandes Ligas,0,1,0,1,2
Grandmother,1,0,1,2,2
Grassley,0,2,0,2,2
Great Pyramid,0,0,2,2,2
grupos pro y anti-Trump,0,0,1,1,2
Guadalajara Cartel,0,1,0,1,2
Guardia Costera,0,0,2,2,2
Halifa Sallah,0,0,2,2,2
Halloween,0,0,2,2,2
"Hangzhou, China",0,0,2,2,2
Hanover,0,2,0,2,2
Harlem Globetrotters,0,0,2,2,2
Harry Truman,0,2,0,2,2
Hassan Jabareen,1,0,0,1,2
"Havana, Cuba",0,0,2,2,2
Hazel Fernandez,2,0,0,2,2
"Health, Education, Labor and Pensions",0,0,2,2,2
Heath Shuler,0,0,2,2,2
Helle Thorning-Schmidt,0,0,2,2,2
"Hempstead, New York",0,0,2,2,2
Henry Ford Museum,0,2,0,2,2
Her Majesty's Government,1,0,0,1,2
High Court,1,0,0,1,2
Hills,2,0,0,2,2
Hiroshima Peace Memorial Park,0,2,0,2,2
Hollander,0,1,0,1,2
Hosni Mubarak,0,0,2,2,2
House Oversight Committee,1,0,0,1,2
Houston Astros,0,0,1,1,2
https://t.co/IeumTasRNN,0,2,0,2,2
HUD,1,1,0,2,2
Hugh Hills,0,0,2,2,2
Human Rights Watch,1,1,0,2,2
Hyundai Motors,0,0,1,1,2
IBM,0,0,1,1,2
IMF,1,1,0,2,2
Inaugural Committee,0,1,0,1,2
Inbar,1,0,1,2,2
Independence Party,1,0,0,1,2
IndyMac,2,0,0,2,2
Infancia,1,0,0,1,2
Inmarsat,1,0,0,1,2
Instituto Cato,0,0,1,1,2
Intel,0,0,1,1,2
Interior Secretary,0,1,1,2,2
International Federation,0,2,0,2,2
Invesco,0,1,0,1,2
iOS,0,0,2,2,2
Iranians,1,0,0,1,2
Iran's nuclear program,0,0,2,2,2
IRINN,0,0,1,1,2
Isaias Samakuva,0,1,0,1,2
Islamic Maghreb,0,0,1,1,2
Islamists,2,0,0,2,2
Israeli police,1,0,0,1,2
Jacksonian,0,1,0,1,2
JAMA Surgery,1,0,0,1,2
Jamaican,0,2,0,2,2
James Buchanan,0,0,1,1,2
James Madison,0,0,2,2,2
Jan. 18,0,0,2,2,2
Janelle Monae,0,0,2,2,2
Jason Miller,0,1,0,1,2
Jason Van Dyke,1,0,0,1,2
Jeff Idelson,1,1,0,2,2
Jeff Miller,0,0,2,2,2
Jeffrey Siminoff,0,0,1,1,2
Jennifer Salke,1,1,0,2,2
Jerry Demings,1,0,0,1,2
Jesus Christ,0,1,0,1,2
Jethro Mullen,0,0,2,2,2
Jews,0,1,0,1,2
Jim Crow,1,0,0,1,2
Jimmy Kimmel,0,2,0,2,2
Joel McHale,0,1,0,1,2
JOHAN ORDÓÑEZ,0,0,1,1,2
John Delury,0,2,0,2,2
John Hay,0,1,0,1,2
John Kerry,0,2,0,2,2
John Wilkes Booth,0,1,0,1,2
Joint Chiefs of Staff,0,0,2,2,2
Jomhouri Avenue,0,0,2,2,2
Jon Danielsson,1,0,0,1,2
"Joplin, Missouri",2,0,0,2,2
Joseph Hibbeln,0,1,0,1,2
JPM,0,0,2,2,2
junio de 2013,0,0,1,1,2
Karen,0,0,2,2,2
Kathryn,2,0,0,2,2
Keegan-Michael Key,0,2,0,2,2
Kendrick Lamar,0,0,2,2,2
Kensington Palace,0,0,2,2,2
King Abdullah,0,2,0,2,2
Kristina Glinina,1,0,0,1,2
Kurdish Peoples' Democratic Party,0,1,0,1,2
La Habana,0,0,2,2,2
Labor Department,1,0,0,1,2
Labor Secretary,0,0,2,2,2
Lamar Alexander,1,0,0,1,2
Last Friday,1,0,1,2,2
Laura Goehler,2,0,0,2,2
Laura Smith,1,0,1,2,2
Lawrence Lipscomb,0,2,0,2,2
Lawrence Summers,0,0,2,2,2
Lazio,2,0,0,2,2
Lebanon,0,1,1,2,2
Leonel Fernández,0,0,1,1,2
Let's go,2,0,0,2,2
Lexi,0,1,0,1,2
Lisa Fithian,0,1,0,1,2
London Palladium,0,0,1,1,2
Lord,0,2,0,2,2
Luca Cari,0,2,0,2,2
Luis V. Gutierrez,0,0,1,1,2
Luis Videgaray,1,0,0,1,2
Lundbeck,2,0,0,2,2
Luther,0,2,0,2,2
Mahmoud Abbas,0,0,2,2,2
Maiduguri,2,0,0,2,2
Make America Great,0,1,0,1,2
Malaysia Airlines,1,0,0,1,2
managing director,0,1,1,2,2
March on Washington,0,0,2,2,2
Marche,2,0,0,2,2
Maria Zakharova,0,0,1,1,2
Marjory Stoneman Douglas High School,0,1,1,2,2
Mark Pryor,0,0,2,2,2
Marlins,0,1,0,1,2
Martin Luther King Jr.,0,2,0,2,2
Martin Luther King Memorial,0,0,2,2,2
Marvin Nicholson,0,0,2,2,2
mayo,0,0,2,2,2
McConnell,0,0,2,2,2
"McLean, Virginia",0,0,2,2,2
Medal of Honor,2,0,0,2,2
Melissa Brown,1,0,0,1,2
Meteorologist,2,0,0,2,2
Metz,0,1,1,2,2
Mexicans,0,0,1,1,2
Michael Brown,2,0,0,2,2
Michael Ferlazzo,1,0,0,1,2
MICHAEL ROIZEN,0,0,1,1,2
Michael Shifter,0,1,0,1,2
Miguel Angel Felix Gallardo,0,0,1,1,2
Milena Veselinovic,0,0,2,2,2
Ministerio de Exteriores,0,1,1,2,2
Ministerio de Relaciones Exteriores y Movilidad Humana,0,0,1,1,2
Minnesota,0,1,1,2,2
Mississippi,0,1,1,2,2
MIT,0,0,1,1,2
Moammar Gadhafi,2,0,0,2,2
Mokhtar Belmokhtar,1,0,0,1,2
"Mon January 23, 2017",0,1,1,2,2
Moneygall,0,0,2,2,2
"Moneygall, Ireland",0,0,2,2,2
Monitor and Combat Trafficking,0,0,1,1,2
Montreal Expos,0,1,0,1,2
Moody's,1,0,1,2,2
Morocco,1,0,1,2,2
Mountain Rescue Service,0,0,2,2,2
Mr,0,1,1,2,2
Mrs.,0,1,1,2,2
Mujtaba Rahman,0,1,0,1,2
My Way,0,1,0,1,2
nacionalista,0,0,1,1,2
"Nairobi, Kenya",0,0,2,2,2
Nasdaq,0,0,2,2,2
Nasr,0,1,0,1,2
National Assembly,0,0,2,2,2
National Center for Missing & Exploited Children,0,1,1,2,2
National Economic Council,0,0,2,2,2
National Pension Service,0,1,0,1,2
National Prayer Breakfast,0,0,2,2,2
National Weather Service,0,0,2,2,2
Navy SEAL,1,0,1,2,2
Nazi,1,0,0,1,2
Nazis,1,0,1,2,2
NBC Universal,1,0,0,1,2
NDM,0,0,1,1,2
New York Democrat,0,1,1,2,2
"Newtown, Connecticut",1,0,1,2,2
Niger,2,0,0,2,2
Nigerian Air Force,0,0,2,2,2
NO WAY,1,0,0,1,2
Norman,2,0,0,2,2
North Carolina,1,1,0,2,2
Norway,0,2,0,2,2
Norwegian Nobel Committee,0,2,0,2,2
Notimex,0,0,2,2,2
البحريني,1,0,0,1,2
الجزائر,0,0,1,1,2
الخليج,1,0,0,1,2
الصحراء,1,0,0,1,2
العربية,0,1,1,2,2
القاضي,1,0,1,2,2
القاهرة,1,1,0,2,2
المغربي,0,1,0,1,2
جبهة البوليساريو,0,1,0,1,2
جامعة القاضي,1,0,0,1,2
عياض بمراكش,1,0,0,1,2
octubre de 2016,0,0,1,1,2
OK,1,0,1,2,2
Oklahoma Geological Survey,0,0,1,1,2
one year,0,0,2,2,2
Orange County Sheriff's,1,0,0,1,2
ORCL,0,0,2,2,2
Orlando Police,1,0,0,1,2
Orlando's Carver Shores,0,0,1,1,2
Oscar Munoz,0,1,0,1,2
Oslo,0,2,0,2,2
Outer Oval Office,2,0,0,2,2
Pacificus VI,0,0,1,1,2
Palantir,1,0,0,1,2
Palestinian Authority,0,0,2,2,2
Palestinians,0,2,0,2,2
Paris Climate Agreement,0,0,2,2,2
"Parkland, Florida",1,0,1,2,2
Pawnee Nation,1,0,0,1,2
"Pawnee, Oklahoma",1,0,0,1,2
PCP,0,0,2,2,2
Pennsylvania State University,0,0,2,2,2
Percyell Tucker,0,2,0,2,2
Pete Rouse,0,0,2,2,2
Peter Bergen,0,0,2,2,2
Petra,0,0,2,2,2
Petteri Taalas,2,0,0,2,2
PGR,0,0,2,2,2
Phil Mattingly,0,0,2,2,2
Phil Schiliro,0,0,2,2,2
Phoenix,0,0,2,2,2
pic.twitter.com/25aQKrOQqb,0,0,2,2,2
pic.twitter.com/3OECTgQjux,0,0,2,2,2
pic.twitter.com/QRGZg1gzbs,0,0,2,2,2
pic.twitter.com/S701FdTCQu,0,0,2,2,2
Pittsburgh,1,0,1,2,2
Poder Judicial del Perú,0,0,1,1,2
"Poland, Germany",1,0,0,1,2
Policía de Parques,0,0,2,2,2
police chief,1,0,1,2,2
Pope Francis,0,0,2,2,2
Portuguese,0,0,1,1,2
President Park,0,0,1,1,2
presidenta,0,0,2,2,2
primer año,0,1,0,1,2
primer día,0,1,0,1,2
Prince George,0,0,2,2,2
Priscilla Peyrot,0,2,0,2,2
Puerto Ricans and people worldwide,0,1,0,1,2
Putin,0,0,2,2,2
Queen Victoria,0,2,0,2,2
R2,0,0,2,2,2
Race for the Cure,0,1,0,1,2
Ralph Ellis,2,0,0,2,2
Ray Buckley,0,0,1,1,2
Rebecca Schimsa,0,1,0,1,2
Red,0,0,1,1,2
Registraduría,0,0,1,1,2
republicano,0,0,2,2,2
Ricardo Sandoval,0,0,1,1,2
Rio de Janeiro,0,0,2,2,2
Robert Menendez,0,0,1,1,2
Roberto Henriquez,0,1,0,1,2
Roger Clemens,1,0,0,1,2
Roll on,0,0,2,2,2
Roma,1,0,1,2,2
Rosa Parks,0,2,0,2,2
Roxana Mendez,1,0,0,1,2
Roxane Gay,0,0,1,1,2
Russian government,0,0,2,2,2
Rutherford B. Hayes,0,0,2,2,2
Saban Forum,0,0,1,1,2
Sadiq Khan,1,0,0,1,2
Sambisa Forest,0,0,2,2,2
San Francisco 49ers,1,0,1,2,2
Sandy Hook,0,0,2,2,2
Sandy Hook school shooting,0,0,2,2,2
Sanjay Kumar,0,1,0,1,2
Santiago initially,0,1,0,1,2
Scott Kirby,0,0,2,2,2
Scottish,0,0,2,2,2
Scripture,0,0,1,1,2
Sean Hayes,1,0,0,1,2
Sean Penn,0,0,1,1,2
secretario de Seguridad Nacional,0,1,1,2,2
Secretary of Commerce,0,2,0,2,2
Secretary of Education,0,2,0,2,2
Secretary of Energy,0,2,0,2,2
Secretary of Health and Human Services,0,1,0,1,2
Secretary of Housing,0,2,0,2,2
secretary of state nominee,0,2,0,2,2
Secretary of Veterans Affairs,0,2,0,2,2
Security Council,0,0,2,2,2
Selby Kiffer,0,0,1,1,2
"Selma, Alabama",2,0,0,2,2
senador,0,0,2,2,2
sergeant,2,0,0,2,2
Sergio Marchionne,1,0,0,1,2
Servicio Secreto,0,0,2,2,2
Seth Fiegerman,1,0,1,2,2
seven months,1,0,1,2,2
seven years,2,0,0,2,2
Seven-month,1,0,0,1,2
Seydou Maiga Moro,0,0,1,1,2
Sgt. 1st Class,0,0,2,2,2
Shake Shack,0,2,0,2,2
Shane Smith,0,2,0,2,2
Shelton,0,2,0,2,2
Shen Dingli,1,0,0,1,2
Sherrod Brown,1,0,0,1,2
Shishmaref,0,0,2,2,2
Shishmaref Erosion and Relocation Coalition,0,0,2,2,2
"Shishmaref, Alaska",0,0,2,2,2
Sierra Madre mountains,2,0,0,2,2
Simon Cullen,0,2,0,2,2
Siria,0,0,1,1,2
six days,2,0,0,2,2
six hours,0,2,0,2,2
Slack,0,1,0,1,2
Snapchat,1,1,0,2,2
So help me God,0,1,0,1,2
socialista,1,0,0,1,2
South Asia,1,0,0,1,2
South China Sea,0,1,1,2,2
South Lawn,0,0,2,2,2
special envoy,1,0,1,2,2
Spider-Man,0,0,2,2,2
St. Patrick,0,0,2,2,2
Star Wars,0,0,2,2,2
Stella Ko,0,1,1,2,2
Stephanie Fritsch,0,0,1,1,2
Stephanie Tobe,0,2,0,2,2
Steve Burke,1,0,0,1,2
Steve Easterbrook,0,1,0,1,2
Steven Jiang,0,2,0,2,2
Suiza,0,1,1,2,2
Super Bowl commercial,0,1,0,1,2
Suráfrica,0,0,1,1,2
Susan Coppedge,1,0,0,1,2
Susan R. Gelman,2,0,0,2,2
Susie Nayokpuk,2,0,0,2,2
Tal Inbar,0,0,2,2,2
Talladega,1,0,0,1,2
Tami Luhby,0,1,1,2,2
Tarahumara,2,0,0,2,2
Tasnim News Agency,0,0,1,1,2
Ted Sarandos,0,1,0,1,2
TED Talk,0,2,0,2,2
Televisa,0,1,0,1,2
Terry Branstad,0,1,0,1,2
The Big Bang Theory,1,1,0,2,2
The Racing Presidents,0,2,0,2,2
Thelma Aldana,0,0,1,1,2
This is Us,1,0,0,1,2
this may,2,0,0,2,2
three days,0,2,0,2,2
three-day,1,0,1,2,2
three-year,1,0,1,2,2
Tijuana,1,0,0,1,2
Tijuana Cartel,1,0,0,1,2
Tinashe Chuchu,0,1,0,1,2
Toby Keith,0,1,1,2,2
Tom Coburn,0,0,2,2,2
Tom Cotton,0,0,2,2,2
Tony Blinken,2,0,0,2,2
transportation secretary,0,2,0,2,2
Tratado de Libre Comercio de América del Norte,0,1,0,1,2
TripAdvisor,0,2,0,2,2
Trump Treasury,1,0,0,1,2
"Tuesday, January 24",2,0,0,2,2
"Tuesday, May 26",0,2,0,2,2
Turner-Fairbank Highway Research Center,0,0,2,2,2
Two weeks,0,0,2,2,2
U.S. Air Force Academy,0,0,2,2,2
U.S. Geological Survey,1,0,0,1,2
U.S. government bonds,1,0,0,1,2
U.S. Senate,0,0,2,2,2
مدير,1,1,0,2,2
UBS,1,0,0,1,2
كانون الثاني 2017,1,1,0,2,2
UK Foreign Office,1,0,0,1,2
Un día,0,2,0,2,2
Una hora,0,0,1,1,2
United Auto Workers,1,0,0,1,2
University of Chicago Institute of Politics,1,0,0,1,2
University of Jordan,0,2,0,2,2
UP,1,0,0,1,2
US administration,0,2,0,2,2
US Bureau of Indian Affairs,1,0,0,1,2
US Department of Justice,1,0,0,1,2
US House,0,1,1,2,2
US Institute for Science and International Security,0,0,2,2,2
US National Defense University,0,0,2,2,2
US senator,0,1,0,1,2
US Supreme Court,2,0,0,2,2
Usain Bolt,0,2,0,2,2
Veterans Affairs Department,0,0,1,1,2
Vogue,0,2,0,2,2
Vote Leave,0,0,1,1,2
Wales,2,0,0,2,2
Wapiti,0,0,1,1,2
Warmington,1,0,0,1,2
Washington AG,0,1,0,1,2
Washington Nationals,0,2,0,2,2
"Washington, D.C.",1,0,1,2,2
"Washington, DC",1,0,1,2,2
Washoe,0,0,1,1,2
"Wednesday, January 11",0,1,1,2,2
White House Colonnade,0,0,2,2,2
White House Correspondents' Association,0,2,0,2,2
White House Maker Faire,0,0,2,2,2
White House Rose Garden,0,0,2,2,2
William Howard Taft,0,0,2,2,2
Winter White House,1,1,0,2,2
WL Ross & Co.,0,0,1,1,2
Woodrow Wilson,0,2,0,2,2
World,0,1,0,1,2
World Health Organization,2,0,0,2,2
World Wrestling Entertainment,0,0,1,1,2
Wynn Resorts,1,0,0,1,2
Yaakov Katz,0,1,0,1,2
Yesterday,0,1,1,2,2
Yongbyon reactor,0,2,0,2,2
Yonsei University,0,0,2,2,2
Zimmer Biomet,1,1,0,2,2
Aaron Tobias,0,0,1,1,2
Abdelrazak,1,0,0,1,2
ACLA Studio,1,0,1,2,2
Addicks Reservoir,0,0,1,1,2
AFP PHOTO,1,0,0,1,2
Ahmed,0,1,0,1,2
Air Salvage International,0,1,0,1,2
Al Gore,0,0,1,1,2
al Qaeda,1,0,0,1,2
ALFREDO ESTRELLA/AFP/Getty Images,0,0,1,1,2
Ali Watkins,1,0,0,1,2
Alice Johnson,0,1,0,1,2
Alliance of Hope,1,0,0,1,2
Al-Milad,0,0,1,1,2
Alysa D. Erichs,1,0,1,2,2
Amanda Watts,1,0,1,2,2
Amazon's Echo,0,1,0,1,2
American Foundation for Suicide Prevention,1,1,0,2,2
American intelligence services,1,0,0,1,2
AMZN,1,1,0,2,2
Andrew Zimmern,0,0,2,2,2
Annise Parker,0,1,0,1,2
Ant,1,0,0,1,2
Antigua,0,0,1,1,2
Arena Condá,1,0,0,1,2
argentina,0,0,1,1,2
Argento,2,0,0,2,2
Arkansas River,1,0,0,1,2
Armenia,0,2,0,2,2
Art Basel,0,1,0,1,2
Asia Argento,0,0,2,2,2
Assistant Attorney General,2,0,0,2,2
Aston Martin DB4GT Zagato,0,1,0,1,2
AVN,0,0,2,2,2
AW609,0,1,0,1,2
B-2,1,0,0,1,2
Baker Hughes,0,1,0,1,2
Bangkok Thailand,0,0,1,1,2
Beaumont,1,0,0,1,2
Belinda Penn,0,0,1,1,2
Ben & Jerry's,0,1,0,1,2
Benghazi,1,0,0,1,2
Bermudian,0,1,0,1,2
Biblioteca Nacional de Cataluña,0,0,1,1,2
Bifengxia Giant Panda Base,0,0,2,2,2
Bill Morneau,0,0,1,1,2
BlueCross BlueShield,0,1,0,1,2
Bob Goodlatte,0,0,1,1,2
"Bolivia,",1,1,0,2,2
Bolton,1,1,0,2,2
Boundary Commission,0,0,1,1,2
Brad Lendon,1,0,1,2,2
Buffalo Bayou,0,0,1,1,2
Burning Man,1,0,0,1,2
CA,0,2,0,2,2
Cape Cod,0,0,2,2,2
Capilano River,1,0,0,1,2
Caribe,1,0,1,2,2
Carlos Alberto Montaner,0,0,1,1,2
Carlos Curbelo,0,1,0,1,2
Carolyn Sung,0,0,2,2,2
Catherine Pham,0,0,1,1,2
CCTV,0,2,0,2,2
Central Pollution Control Board,1,0,0,1,2
"Centralia, Illinois",0,0,1,1,2
Chadds Ford,0,0,1,1,2
Chick-fil-A,1,0,0,1,2
chief international correspondent,2,0,0,2,2
Cho,0,0,2,2,2
Chris Van Hollen,0,1,0,1,2
Christopher Doyle,0,0,2,2,2
Clare Foran,1,0,1,2,2
Cliff Sims,1,0,0,1,2
Coalition,1,0,1,2,2
Cole Smith,0,0,2,2,2
Colleen,2,0,0,2,2
Colts,0,0,1,1,2
Consejo de Seguridad Nacional,1,0,0,1,2
Cook,0,0,2,2,2
Cooper,2,0,0,2,2
Coordinadora Nacional,1,0,1,2,2
"Corpus Christi, Texas",0,0,1,1,2
Corte Federal del Distrito Sur,0,1,0,1,2
Cortesía Rémy Michelin,0,0,1,1,2
Crisis Text Line,1,0,1,2,2
cuatro días,0,0,1,1,2
cuatro meses,0,0,1,1,2
Culinary School,0,0,2,2,2
DACA,0,1,0,1,2
Daily Beast,1,0,0,1,2
Daisy Graham,1,0,0,1,2
Dalian,0,0,2,2,2
Damon Harbison,1,0,0,1,2
Danube river,0,1,0,1,2
Daphne Wu,0,0,2,2,2
David S. Holloway,0,0,1,1,2
Delaware,1,0,1,2,2
Democratic Congress,0,0,1,1,2
Departamento de Policía de Nueva York,0,1,1,2,2
Department of Agriculture,1,0,0,1,2
Department of Homeland Security,1,0,0,1,2
Department's inspector general,0,0,2,2,2
despacho oval,0,0,1,1,2
Dijo Jim Caldwell,0,0,1,1,2
director of photography,0,0,2,2,2
District of South Carolina,1,0,0,1,2
DJ,2,0,0,2,2
Do Jong-hwan,0,0,2,2,2
domingo 10 de junio,0,0,1,1,2
Donald Trump Jr.,1,0,0,1,2
Downing Street,0,0,1,1,2
Dutch,0,0,2,2,2
Edison Lee,1,0,0,1,2
Edward Burtynsky,0,1,0,1,2
Edward Lee,0,0,2,2,2
Ehsan Popalzai,0,0,1,1,2
El Porvenir,0,0,1,1,2
Embraer,1,0,1,2,2
Emir Kusturica,0,1,0,1,2
EMSC,1,0,0,1,2
Er Fu Zhong,1,0,0,1,2
Erbenheim,1,0,0,1,2
Eric Adams,1,0,0,1,2
Erin Egan,0,0,2,2,2
Eritrea,0,1,0,1,2
Ermias,0,0,1,1,2
Escuela Católica St,0,0,1,1,2
Escuela Cristiana,0,0,1,1,2
España y,0,0,2,2,2
Ethiopian Airlines,0,0,1,1,2
ex-attorney,1,1,0,2,2
executive chairman,2,0,0,2,2
executive secretary,2,0,0,2,2
Fe Y Alegria School,0,0,1,1,2
febrero,0,1,1,2,2
Felipe VI,1,0,0,1,2
FEMA,1,1,0,2,2
Ferrari,0,1,0,1,2
Finland,0,1,0,1,2
Finnish,0,0,1,1,2
first month,0,2,0,2,2
Five years,0,0,1,1,2
"Florence, Italy",1,0,0,1,2
Flushing,0,0,2,2,2
Food Network,0,0,2,2,2
Foreign Secretary,2,0,0,2,2
"Fort Bend County, Texas",0,0,1,1,2
Fortune 500,0,1,0,1,2
Fox Business Network,0,1,0,1,2
Frank Slevin,1,0,0,1,2
Fresh Air,0,0,2,2,2
"Friday, August 25",0,0,1,1,2
Fuego Volcano,2,0,0,2,2
FYI,0,2,0,2,2
Gang of Eight,1,0,0,1,2
GE Power,1,0,0,1,2
George Mallory,0,0,1,1,2
gerente general,0,0,2,2,2
Gerrick Johnson,1,0,0,1,2
GETTY IMAGES,0,0,2,2,2
Gilda Gutierrez,1,0,0,1,2
"Gilgit-Baltistan, Pakistan",0,1,0,1,2
Gina Rodriguez,1,0,0,1,2
Glenelg,0,0,1,1,2
Graduate Management Admission Council,0,2,0,2,2
Greek,0,2,0,2,2
Gregory Wallace,2,0,0,2,2
Gustavo Gallardo,0,0,1,1,2
Harry Stone,1,0,0,1,2
Hawaii County Civil Defense Agency,0,0,2,2,2
Healey,1,0,0,1,2
Hedy Lamarr,0,1,0,1,2
Helsinki,0,1,0,1,2
Hernández Solarte,0,0,1,1,2
Hewitt,0,1,0,1,2
HISTORIC Rescissions Package,1,0,0,1,2
Honore Nabere Traore,0,0,1,1,2
Horn of Africa,1,0,1,2,2
House Democratic,1,0,0,1,2
Houston nightclub,1,0,0,1,2
HOWRAH,1,0,0,1,2
Hua Jiao,0,2,0,2,2
Hunt,1,0,0,1,2
Iftar dinner,0,0,1,1,2
Institute of Forensic Sciences,2,0,0,2,2
Instituto Nacional de Estadística y Geografía,0,0,1,1,2
Intelligence Chairman,0,2,0,2,2
International Business Strategies,1,0,0,1,2
International Federation of Red Cross,2,0,0,2,2
International Space Station,0,1,1,2,2
Interpol,0,1,0,1,2
Interstate 25,0,0,1,1,2
Iron Curtain,0,1,0,1,2
Jackson Odell,1,0,0,1,2
JAMA,1,0,0,1,2
James Bond,1,1,0,2,2
James McQuivey,0,0,1,1,2
Jane Cooke Wright,1,0,0,1,2
Jeff T. Bernard,0,0,2,2,2
Jerry Van Dyke,1,0,0,1,2
Joe DiMaggio,0,2,0,2,2
John Erzen,0,1,0,1,2
John Kennedy,1,0,0,1,2
John Podesta,0,1,1,2,2
Jordan Valinsky,2,0,0,2,2
Juan Fernando Galindo,1,0,0,1,2
Jumbo Stay,0,1,0,1,2
JUNE,0,2,0,2,2
June 12th,2,0,0,2,2
Justice,0,1,0,1,2
Justin Timberlake,1,0,0,1,2
Kapoho,1,0,0,1,2
Kat West,1,0,0,1,2
Katy Scott,0,0,1,1,2
KBS,0,0,2,2,2
Keinon Carter,1,0,0,1,2
Kevin Liptak,1,0,1,2,2
KFC,0,1,0,1,2
Kim Kardashian,1,1,0,2,2
Kim Yong Nam,0,0,2,2,2
king,1,1,0,2,2
King Ferdinand,0,0,1,1,2
Kirstjen Nielsen,2,0,0,2,2
KMGH,0,0,1,1,2
Kolkata,0,0,1,1,2
Korn Ferry,0,1,0,1,2
Kwegyirba Croffie,0,1,0,1,2
La Federación Internacional de la Cruz Roja,0,0,1,1,2
La Reunion Golf Course Resort,0,2,0,2,2
Línea Nacional de Prevención del Suicidio,0,0,1,1,2
Larry Harvey,1,0,0,1,2
Larry Kudlow,1,0,0,1,2
Laura Koran,0,0,2,2,2
"Leonia, New Jersey",0,2,0,2,2
Letizia,0,1,0,1,2
LGBTQ,1,1,0,2,2
Library of Congress,1,0,0,1,2
Linda Brown,1,0,0,1,2
Little League,0,0,2,2,2
Love,0,1,0,1,2
Lyft,0,0,1,1,2
Mach,0,0,1,1,2
Major League Soccer,0,0,1,1,2
Mapimi Biosphere Reserve,1,0,0,1,2
Marco Arana Zegarra,0,1,0,1,2
Maren Sarkarat,1,0,0,1,2
Margot Kidder,1,0,0,1,2
Mariela de los Angeles Carrillo de Galindo,1,0,0,1,2
Marine Discovery Centre,0,1,0,1,2
Mark J. MacDougall,0,0,1,1,2
Mars Reconnaissance Orbiter,0,0,1,1,2
Martian soil,0,0,1,1,2
Mary McDougall,1,0,1,2,2
MCH Group,0,1,0,1,2
Me,0,1,0,1,2
Meet the Press,0,1,1,2,2
mexicanos,0,1,0,1,2
Michael Bates,0,0,1,1,2
Mick Zais,0,0,1,1,2
Miguel Díaz Canel,0,0,1,1,2
Ministerio de Justicia,0,0,1,1,2
Ministerio de Relaciones Exteriores de Colombia,0,0,1,1,2
Mohamad Aljefri,0,1,0,1,2
"Monday, June 4",2,0,0,2,2
NAACP,0,1,0,1,2
National Bioethics Advisory Commission,0,0,1,1,2
National Coordination for Disaster Reduction,0,0,2,2,2
National Defense Authorization,0,2,0,2,2
National Library of Catalonia,1,0,0,1,2
National Museum of African American History,0,1,0,1,2
National Republican Congressional Committee,2,0,0,2,2
national security chief,0,0,2,2,2
National Seismological Volcanic and Meteorological Institute,2,0,0,2,2
National Union,0,2,0,2,2
NBA Finals,1,1,0,2,2
New Jersey State Police,1,0,0,1,2
New York City medical examiner,1,1,0,2,2
NHL,1,0,0,1,2
Nick Flynn,1,0,0,1,2
Nikkei,0,1,0,1,2
North Korean military,0,0,2,2,2
North Vancouver,0,0,1,1,2
Northrop,1,0,0,1,2
Not fair,1,1,0,2,2
داليا دغمش,0,0,1,1,2
شريف إسماعيل,1,0,0,1,2
أبو عمر المصري,0,1,0,1,2
أنور قرقاش,1,0,0,1,2
الدكتور,0,0,2,2,2
الشيخ,2,0,0,2,2
الأردنية,0,1,0,1,2
الأمريكية,0,1,0,1,2
الأمير,2,0,0,2,2
الرزاز,1,0,0,1,2
العربي,2,0,0,2,2
الوكالة السعودية,0,1,1,2,2
القطريين,1,0,0,1,2
النائب,0,0,2,2,2
الكويتي,0,0,1,1,2
اليابانية,1,0,0,1,2
جدة,1,0,0,1,2
خمسة أيام,2,0,0,2,2
عبدالله,0,1,0,1,2
سلطان بن سحيم آل ثاني,1,0,0,1,2
Oedipus,0,1,0,1,2
Pakistani,0,1,1,2,2
Paul Zollo,0,0,1,1,2
Pentagon building,0,0,1,1,2
Philadelphia Eagles,1,1,0,2,2
Philip Roth,1,0,0,1,2
"Phoenix, Arizona",0,0,2,2,2
pic.twitter.com/LbIeZK14ia,0,2,0,2,2
pic.twitter.com/orEXIaEMZM,2,0,0,2,2
Pietschmann,0,0,1,1,2
Piscataway,0,0,1,1,2
Port Aransas,1,0,0,1,2
Port of Spain,2,0,0,2,2
Public Good,0,1,0,1,2
Public Ministry,2,0,0,2,2
QCOM,0,2,0,2,2
Qualcomm,0,1,1,2,2
Queen Isabella,1,0,0,1,2
R. Lee Ermey,1,0,0,1,2
Red Crescent Societies,2,0,0,2,2
Red Sea,0,1,0,1,2
Reefscrapers,1,0,0,1,2
Rene Marsh,1,0,1,2,2
Richard Burr,0,1,1,2,2
Richard Nixon,1,0,1,2,2
Rita Levi-Montalcini,0,0,1,1,2
Riyadh,0,0,2,2,2
Robert A. Knox,0,1,1,2,2
Robin Williams,0,0,1,1,2
"Rockport, Texas",0,0,1,1,2
Roger Wicker,0,1,0,1,2
Rohingya,1,0,0,1,2
Ronnie Walker,1,0,0,1,2
Ross School,0,1,0,1,2
Royal Academy of Arts,0,1,0,1,2
Russian Prime Minister,0,0,1,1,2
Sally Ride,0,1,0,1,2
Salvadoran,1,0,0,1,2
Sam Roggeveen,1,0,0,1,2
Samantha Wallace,0,0,1,1,2
Samsung Galaxies,0,1,0,1,2
Sarah Paulson,0,0,1,1,2
Sean Hannity,1,0,0,1,2
Sean Hannity's show,1,0,0,1,2
SEC filings,1,0,0,1,2
Secretaría Judicial,0,1,0,1,2
Sen. Ron Johnson,0,0,1,1,2
Senate Intelligence Committee,1,0,1,2,2
senior research director,0,1,1,2,2
Senkaku,0,0,1,1,2
Shan State,0,1,0,1,2
Sharp,1,0,0,1,2
Shelley Moore Capito,0,0,1,1,2
Shriners,0,0,2,2,2
Shriners Hospital,0,0,2,2,2
Sichuan,0,0,1,1,2
Sichuan Province,0,0,1,1,2
siete años,0,0,1,1,2
siete días,0,1,1,2,2
Silk Road,0,0,2,2,2
Sistema Nacional de Estadísticas Vitales,0,1,0,1,2
SK Hynix,0,0,1,1,2
So what,0,1,1,2,2
SoftBank,0,0,1,1,2
Sojourner Truth,0,1,0,1,2
South Korean military,2,0,0,2,2
"Spring, Texas",0,0,1,1,2
St,1,0,0,1,2
St. Mary's Hospital,1,0,0,1,2
Stephen Paddock,1,0,0,1,2
styrofoam,0,0,1,1,2
"Sunday, June 10",0,0,1,1,2
Suzanne Malveaux,0,1,1,2,2
Swedish,1,0,0,1,2
Swiss Alps,0,1,0,1,2
Tagore International School,0,0,1,1,2
Takuya Yokota,0,0,1,1,2
Talmadge Magno,1,0,0,1,2
Tarbes,0,0,1,1,2
Tarmac,0,0,1,1,2
Tatiana,0,0,1,1,2
TCL Communication,0,1,0,1,2
"Tel Aviv, Israel",0,2,0,2,2
Telstra,1,0,0,1,2
Ten years,2,0,0,2,2
Tennessee,1,1,0,2,2
Tessa Berenson,0,2,0,2,2
The Cranberries,1,0,0,1,2
three decades,0,1,1,2,2
TIME,0,1,0,1,2
Timothy Heath,0,1,0,1,2
Tom Wolfe,1,0,0,1,2
totipotent,0,1,0,1,2
Transparency,0,1,0,1,2
Treasury's Office of Foreign Assets Control,0,1,0,1,2
Trevor Edwards,1,0,0,1,2
Trinidad,2,0,0,2,2
"Tuesday, June 5",1,1,0,2,2
وزراء,0,1,1,2,2
وزارة الإسكان,0,0,1,1,2
مدحت الشريف,0,1,0,1,2
مجلس التعاون لدول الخليج العربي,0,2,0,2,2
مجلس التنسيق السعودي الإماراتي,2,0,0,2,2
مصطفى موسى,0,1,0,1,2
UK government,1,0,1,2,2
Underbelly,0,2,0,2,2
Unequal Technologies,0,0,1,1,2
Unification Minister,0,0,2,2,2
United Arab Emirates,1,0,1,2,2
Upwork,1,0,0,1,2
US Air Force Academy,0,0,2,2,2
US bank,1,0,0,1,2
ياسر جلال صديق عمر,0,0,1,1,2
Vanity Fair,0,0,1,1,2
Vegas,1,0,0,1,2
Victor Carlioz,1,1,0,2,2
VII Mentor Program Beijing,1,0,0,1,2
Vladimir Lenin,0,0,1,1,2
Walton Brown,0,1,0,1,2
Wang Yi,1,0,0,1,2
Warner Channel,0,0,1,1,2
Warriors,2,0,0,2,2
"Washington, DC.",0,0,1,1,2
Wellesley College,0,0,1,1,2
West Coast,1,0,0,1,2
Winnebago,0,0,1,1,2
Wolong Nature Reserve,0,1,0,1,2
Wonsan,0,0,2,2,2
World Bank,2,0,0,2,2
Yale Law School,0,0,1,1,2
Yasiri Valle,0,1,0,1,2
Yellowknife Bay,0,1,0,1,2
Yoko Wakatsuki,0,1,1,2,2
YTN,0,0,2,2,2
Zero Point Zero Production,0,2,0,2,2
Zhang Hemin,0,0,2,2,2
ZipRecruiter,0,0,1,1,2
ZPZ,0,0,2,2,2
AAL,0,0,1,1,1
Aaron Kessler,0,0,1,1,1
Aaron Smith,0,0,1,1,1
Abby Phillip,0,0,1,1,1
ABC News,1,0,0,1,1
Abdy Suselly Estrada,1,0,0,1,1
Abel Maldonado,0,1,0,1,1
Abigail Crutchfield,1,0,0,1,1
Abril de 2016,1,0,0,1,1
Access Hollywood,0,1,0,1,1
ADDS,0,0,1,1,1
adjunct professor of law,0,0,1,1,1
ADM,1,0,0,1,1
Administración de Seguridad de Transporte,0,0,1,1,1
Administración Federal de Aviación,0,0,1,1,1
Advisory Board,0,0,1,1,1
Aeropuerto Internacional de Cancún,0,0,1,1,1
AFP,1,0,0,1,1
Agencia de Seguridad Nacional,0,1,0,1,1
agent,1,0,0,1,1
ago,0,1,0,1,1
Agriculture Department,0,1,0,1,1
agriculture secretary,1,0,0,1,1
Airbnb,1,0,0,1,1
Aircraft Communications,1,0,0,1,1
Al-Akhbar,0,0,1,1,1
Alanna Petroff,0,0,1,1,1
Alberta,0,0,1,1,1
"Albuquerque, New Mexico",0,0,1,1,1
alcalde,0,0,1,1,1
Alex Felton,0,1,0,1,1
Alistair Esfahanizadeh,0,1,0,1,1
Allegiant,0,1,0,1,1
Alt Reich,0,0,1,1,1
Altiplano,1,0,0,1,1
Amen.,1,0,0,1,1
America 00:17 Washington,0,1,0,1,1
America Movil,0,0,1,1,1
American Board of Anesthesiology,0,0,1,1,1
American Chamber of Commerce in China,0,0,1,1,1
American League MVP,0,0,1,1,1
American Medical Association,0,0,1,1,1
American South,0,0,1,1,1
America's Got Talent,0,0,1,1,1
Ameriprise chief market strategist,0,1,0,1,1
Amnesty International and Human Rights Watch,1,0,0,1,1
Amtrak,0,1,0,1,1
Amy Schumer,0,1,0,1,1
Ana Maria Salazar,0,1,0,1,1
Andes,1,0,0,1,1
Andrew Puzder,0,1,0,1,1
Andrew Stroth,1,0,0,1,1
Angelica,0,0,1,1,1
Angolans,0,0,1,1,1
Annals of Internal Medicine,0,0,1,1,1
Antarctica,0,0,1,1,1
Anthony Guglielmi,1,0,0,1,1
Antonio Nemi Dib,0,1,0,1,1
Apple News,0,0,1,1,1
AQIM,0,0,1,1,1
Arab Jerusalem,1,0,0,1,1
Arab Joint List Party,0,0,1,1,1
Archbishop of Guadalajara,1,0,0,1,1
Archie Bunker,1,0,0,1,1
argentinos,0,0,1,1,1
Arizona John,0,0,1,1,1
Arthur Okun,0,0,1,1,1
Ashley Strickland,1,0,0,1,1
asociación para delinquir,0,1,0,1,1
assistant secretaries,1,0,0,1,1
associate dean,0,1,0,1,1
Athens Banner-Herald,1,0,0,1,1
Atlassian,1,0,0,1,1
attorney general and secretary,0,0,1,1,1
attorney general nominee Sen.,0,0,1,1,1
attorney representing,0,1,0,1,1
ATV,0,0,1,1,1
Aurelio Nuño,0,1,0,1,1
Aurora,0,0,1,1,1
aviation correspondent,0,1,0,1,1
Avigdor Lieberman,0,0,1,1,1
Axel Weber,0,0,1,1,1
Axioma,1,0,0,1,1
Ayla Brown,0,0,1,1,1
Ayman Odeh,0,0,1,1,1
Azerbaján,0,0,1,1,1
Baghdad,0,0,1,1,1
Bank,0,0,1,1,1
Bank of America ( BAC,0,0,1,1,1
bank.The,1,0,0,1,1
Bannon and Priebus,0,1,0,1,1
Barney Keller,1,0,0,1,1
Barry Pollack,0,1,0,1,1
baseball writer,0,0,1,1,1
Baseball Writers Association of America,0,1,0,1,1
BBC,1,0,0,1,1
Bear Stearns,0,1,0,1,1
"Bedminster Township, New Jersey",0,0,1,1,1
Bedouin Development and Settlement Authority,0,0,1,1,1
Bedouins,0,0,1,1,1
Belarus,1,0,0,1,1
Betty,0,0,1,1,1
Betty DeVos,0,0,1,1,1
Beyoncé,1,0,0,1,1
Beyonce,0,0,1,1,1
Biden,0,1,0,1,1
Big Daddy Mike,0,1,0,1,1
Bilateral Investment Treaty,0,1,0,1,1
bilateralism,0,0,1,1,1
Bild,0,1,0,1,1
BILD Zeitung,0,1,0,1,1
Bill Cassidy,1,0,0,1,1
Bill Nelson,0,0,1,1,1
Bill Reitzel,0,0,1,1,1
Bill Schuette,1,0,0,1,1
Birmingham,1,0,0,1,1
Black Lives Matter,0,1,0,1,1
Black Mirror,0,1,0,1,1
Boa Vista,1,0,0,1,1
Bob Casey,1,0,0,1,1
Bob Ferguson,0,0,1,1,1
Bob Menendez,0,0,1,1,1
bond fund manager,1,0,0,1,1
Bonzi Mathurin,0,1,0,1,1
Boston Consulting Group,0,0,1,1,1
Brain Health Education and Research Institute,0,0,1,1,1
Brian Jackson,0,0,1,1,1
Brian Kilmeade,1,0,0,1,1
British American Tobacco,0,0,1,1,1
British Cabinet,1,0,0,1,1
British monarchy,0,1,0,1,1
Brooking Institution,0,0,1,1,1
Brookings Doha Center,0,1,0,1,1
Broward County Sheriff,1,0,0,1,1
Brunel Shipping & Liner Services,0,0,1,1,1
Bryon Bailey,0,1,0,1,1
BTI,0,0,1,1,1
Bud Selig,0,1,0,1,1
Buddhism,0,1,0,1,1
Buddhist,0,1,0,1,1
Bush strategist,0,1,0,1,1
Business Sciences,0,0,1,1,1
Businesswoman,0,1,0,1,1
Buzzfeed,0,1,0,1,1
Cade,0,0,1,1,1
Caesar,0,1,0,1,1
Cairo,0,1,0,1,1
"California, Texas, Illinois",0,1,0,1,1
"Camden, New Jersey",1,0,0,1,1
Campaign Legal Center,0,1,0,1,1
Campus Ciudad de México,0,0,1,1,1
Canadian Broadcasting Corporation,0,0,1,1,1
Capital Economics,1,0,0,1,1
Capitol building,1,0,0,1,1
Capitol complex,0,1,0,1,1
Capitol Selections for Health and Human Services,1,0,0,1,1
Capitolio de Estados Unidos,0,0,1,1,1
Capt.,0,1,0,1,1
Caribbean,0,0,1,1,1
caritas,1,0,0,1,1
carjacking,0,0,1,1,1
Carla Peterson,0,1,0,1,1
Carlos Castellanos,0,0,1,1,1
Carlos Joaquín,0,0,1,1,1
Caroline Kenny,0,0,1,1,1
"Carter Center, told Africa",0,1,0,1,1
Casa Blanca de Invierno,0,1,0,1,1
Catedral Nacional,0,1,0,1,1
Catholic Relief Services,0,0,1,1,1
CBO,1,0,0,1,1
CBS Sports,1,0,0,1,1
Celtic,0,1,0,1,1
Center for Automotive Research,0,0,1,1,1
Centro Comercial Plasco,0,0,1,1,1
Centro de Cancerología de Xalapa,0,1,0,1,1
Centro de Estudios Estratégicos e Internacionales,0,0,1,1,1
Centro Estatal de Cancerología,0,0,1,1,1
Chabahar,1,0,0,1,1
Chad Warmington,0,1,0,1,1
chairman and chief strategy officer,0,0,1,1,1
Chairman of President,0,0,1,1,1
Chairman-elect,0,0,1,1,1
Chamber of Commerce,0,0,1,1,1
Channel Tunnel,0,1,0,1,1
Charles Ramsey,0,0,1,1,1
Charles Schumer,0,1,0,1,1
Chelyabinsk region,0,0,1,1,1
Chevy Chase,0,1,0,1,1
Chevy Chase Circle,0,0,1,1,1
Chicago PD,1,0,0,1,1
Chief,1,0,0,1,1
chief content officer,0,1,0,1,1
chief nominated for secretary of state,0,0,1,1,1
chief operating officer,0,1,0,1,1
chief policy adviser,0,1,0,1,1
chief strategist,1,0,0,1,1
chief White House strategist,0,1,0,1,1
China's central bank,1,0,0,1,1
Chloe Melas,0,0,1,1,1
CHP,0,1,0,1,1
Christies,0,0,1,1,1
cientos de años,1,0,0,1,1
Cincinnati Zoo,1,0,0,1,1
CIT,0,1,0,1,1
Citigroup ( C,0,0,1,1,1
City of London,1,0,0,1,1
ciudad de Cotacachi,0,1,0,1,1
Claro,1,0,0,1,1
Claro Sports,0,0,1,1,1
CNN Films,0,0,1,1,1
CNN Heroes,0,1,0,1,1
CNN.com,0,0,1,1,1
CNNMONEY,0,0,1,1,1
Coats,0,1,0,1,1
co-CEO,0,1,0,1,1
co-director,1,0,0,1,1
Cody,0,0,1,1,1
cofounder,0,1,0,1,1
Cognitive Sciences,0,0,1,1,1
Cohen Milstein,0,1,0,1,1
Coke,0,0,1,1,1
Col.,0,0,1,1,1
"College Park, Maryland",0,0,1,1,1
Colombian,1,0,0,1,1
columnist,0,1,0,1,1
comandante les,1,0,0,1,1
Comcast ( CCV,0,1,0,1,1
Comisión Internacional,0,1,0,1,1
commander-in-chief,1,0,0,1,1
commentator,0,1,0,1,1
Commerce Secretary nominee,1,0,0,1,1
comunista,1,0,0,1,1
Congo,0,0,1,1,1
consejo de Confianza y Seguridad,0,0,1,1,1
Constitución de los Estados Unidos,0,0,1,1,1
Constitution of the United States,0,1,0,1,1
Continental Resources,0,0,1,1,1
Contributor,0,0,1,1,1
Cook County State's Attorney's Office,1,0,0,1,1
Corollas,1,0,0,1,1
corte,1,0,0,1,1
Corte Suprema de Estados Unidos,0,0,1,1,1
Crackle,1,0,0,1,1
Cristina Fernández de Kirchner,0,0,1,1,1
Crown,0,1,0,1,1
crude oil,1,0,0,1,1
Cruelty Hotline,1,0,0,1,1
CTV News,0,0,1,1,1
Cummings Oil Co.,0,0,1,1,1
Cushing,1,0,0,1,1
"Cushing, Oklahoma",1,0,0,1,1
Cy Young,0,1,0,1,1
D. Michael Hancock,0,1,0,1,1
Daddy Pence,0,1,0,1,1
Dakar,0,1,0,1,1
Dale Schmidt,1,0,0,1,1
Dallas/Fort Worth,0,1,0,1,1
Damascus,0,0,1,1,1
Dan Pfeiffer,0,0,1,1,1
Dan Simon,1,0,0,1,1
Danny Dannon,0,0,1,1,1
Dave Hennen,0,0,1,1,1
David Fahrenthold,0,0,1,1,1
David Fitzpatrick,0,1,0,1,1
David Friedman,0,1,0,1,1
David Joy,0,1,0,1,1
David Kang,0,0,1,1,1
David Kohan,0,0,1,1,1
David Urban,0,1,0,1,1
Deborah Hellinger,1,0,0,1,1
"December 31st, 2012",0,0,1,1,1
Deirdre Walsh,0,0,1,1,1
Democracy promotion,0,1,0,1,1
democratic,0,0,1,1,1
Dems,0,1,0,1,1
Departamento de Policía de Washington,1,0,0,1,1
Departamento de Seguridad Nacional,0,0,1,1,1
Department of Health and Human Services,1,0,0,1,1
Department of Interior,0,1,0,1,1
Departments of Agriculture and Veterans Affairs,0,0,1,1,1
deputy assistant secretary of defense,0,0,1,1,1
Deputy Homeland Security Advisor and Deputy Assistant,0,0,1,1,1
deputy national security adviser,0,0,1,1,1
deputy prime minister,0,1,0,1,1
deputy secretary,0,0,1,1,1
deputy superintendent,0,0,1,1,1
Diana Ross,1,0,0,1,1
diciembre,0,0,1,1,1
diciembre de 2015,0,0,1,1,1
Dilma Rousseff,0,0,1,1,1
director nominee,0,0,1,1,1
director of investments,0,0,1,1,1
directora general,0,1,0,1,1
District Magistrate,1,0,0,1,1
División de Promoción de la Calidad,0,0,1,1,1
Dolartoday.com,1,0,0,1,1
Domestic Energy Producer's Alliance,0,0,1,1,1
domingo 19 de febrero,0,1,0,1,1
dominicano,0,0,1,1,1
Don King,0,1,0,1,1
Don Stewart,0,1,0,1,1
Donald Jr.,0,1,0,1,1
Donna Ryu,1,0,0,1,1
dos horas,0,0,1,1,1
Dragon's Den,1,0,0,1,1
Drew Griffin,0,0,1,1,1
Drudge Report,1,0,0,1,1
Duarte,0,0,1,1,1
Eagle Road Oil LLC,0,0,1,1,1
East Coast,1,0,0,1,1
East Jerusalem,0,1,0,1,1
economist,1,0,0,1,1
economista,0,0,1,1,1
economy minister,0,0,1,1,1
Ecuadorian embassy,0,0,1,1,1
Ecuadorian Embassy,0,0,1,1,1
ecuatoriana,1,0,0,1,1
Ed Meese III,0,0,1,1,1
Egipto,1,0,0,1,1
Egyptian media,1,0,0,1,1
Egyptians,1,0,0,1,1
El fotógrafo,0,0,1,1,1
El Niño,1,0,0,1,1
Elect,0,1,0,1,1
Electoral College,0,1,0,1,1
Electronic Frontier Foundation,0,0,1,1,1
Elle,1,0,0,1,1
Ellen DeGeneres,0,1,0,1,1
Ellen Johnson Sirleaf,0,0,1,1,1
Elsa Price,0,0,1,1,1
Emanuella Grinberg,1,0,0,1,1
Emory Law School,0,0,1,1,1
endemic,0,0,1,1,1
Energy Department,1,0,0,1,1
Energy secretary nominee,0,0,1,1,1
Enero,0,0,1,1,1
enero,0,0,1,1,1
enero de 1989,0,0,1,1,1
enero de 2001,0,0,1,1,1
Enforcement Analyst,0,0,1,1,1
engineer,1,0,0,1,1
Enrique Peña Nieto,0,1,0,1,1
entertainer,0,0,1,1,1
entertainment chairman,0,1,0,1,1
Entertainment Tonight,0,0,1,1,1
Environment and Public Works,1,0,0,1,1
EPA's Office of the Inspector General,0,0,1,1,1
Erez Levi,1,0,0,1,1
Eric,0,0,1,1,1
Eric Holder,0,0,1,1,1
Escuela Chan,0,0,1,1,1
Escuela de Salud Pública T.H. Chan de Harvard,0,0,1,1,1
Espionage Act,0,0,1,1,1
Esta,0,0,1,1,1
ethics chief 02:26,0,1,0,1,1
ethics director,1,0,0,1,1
Etsy,0,0,1,1,1
Eurasia Group,1,0,0,1,1
European movement,0,1,0,1,1
Evan Simko-Bednarski,1,0,0,1,1
"Evanston, Illinois",1,0,0,1,1
ex Presidente,0,1,0,1,1
exdirector,0,0,1,1,1
Executive Chairman,0,1,0,1,1
Executive Director,0,0,1,1,1
exembajador,0,0,1,1,1
ex-NFLer,0,1,0,1,1
exsecretario de Salud,0,1,0,1,1
Exxon,1,0,0,1,1
Exxon Mobil,0,1,0,1,1
Fasci,0,0,1,1,1
"Fayetteville, North Carolina",0,1,0,1,1
FDIC,1,0,0,1,1
Federal Election Commission,1,0,0,1,1
Federal Prison,0,0,1,1,1
Federal Triangle,0,0,1,1,1
Feds,1,0,0,1,1
Filipino,0,0,1,1,1
finance ministry,1,0,0,1,1
finance professor,1,0,0,1,1
First Baptist Church,0,0,1,1,1
First lady,1,0,0,1,1
first months,1,0,0,1,1
First Presbyterian Church,0,0,1,1,1
First Sergeant,1,0,0,1,1
first three days,0,0,1,1,1
Fiscal General,0,0,1,1,1
five hours,0,0,1,1,1
five inches,1,0,0,1,1
five year,1,0,0,1,1
FiveThirtyEight,0,1,0,1,1
Flint Northwestern High School,0,0,1,1,1
Flint River,1,0,0,1,1
For Mrs.,0,0,1,1,1
Foreign Narcotics Kingpin Designation,1,0,0,1,1
Fort Hood,1,0,0,1,1
Forty-eight hours,0,1,0,1,1
four-hour,1,0,0,1,1
fox,0,0,1,1,1
Fox and Friends,0,1,0,1,1
Fox Business,0,1,0,1,1
Fox News Channel,0,0,1,1,1
Freedom Riders,0,0,1,1,1
"Fri January 25, 2013",0,0,1,1,1
"Friday, December 9",0,1,0,1,1
"Friday, February 10",0,0,1,1,1
"Friday, February 17",0,1,0,1,1
"Friday, January 20",0,1,0,1,1
"Friday, November 11",0,1,0,1,1
Friendship Heights,0,1,0,1,1
From Russia with love,0,1,0,1,1
Frontmen of Country,0,0,1,1,1
Fudan University,0,1,0,1,1
FX,0,0,1,1,1
G20,0,0,1,1,1
Galaxy Note 7,1,0,0,1,1
Gamboa His,0,1,0,1,1
General Director,0,0,1,1,1
GEORGE CASTELLANOS,1,0,0,1,1
George Mason University Center for Climate Change Communication,0,0,1,1,1
George Stephanopoulos,1,0,0,1,1
Georgetown University,0,0,1,1,1
Giants,0,1,0,1,1
Girls Who Code,0,0,1,1,1
Glee,0,1,0,1,1
Global News,0,0,1,1,1
Global Times,1,0,0,1,1
Gloria Borger,0,0,1,1,1
gobernador de Teherán,0,0,1,1,1
god,0,0,1,1,1
Gold Elite,0,1,0,1,1
Golden Globes,1,0,0,1,1
Goldman Sachs ( GS,0,0,1,1,1
Good Morning America,0,0,1,1,1
goodwill ambassador,0,1,0,1,1
Government Communications Headquarters,0,1,0,1,1
Grace Adler,1,0,0,1,1
Grady Memorial Hospital,1,0,0,1,1
"Grand Rapids, Michigan",0,0,1,1,1
Great Plains Livestock Consulting,0,1,0,1,1
Greensville Correctional Center,1,0,0,1,1
Greta Van Susteren,0,1,0,1,1
Groupe Eurotunnel,0,0,1,1,1
Guantanamo,0,0,1,1,1
Guantanamo Bay detainees,0,1,0,1,1
Guardian,0,1,0,1,1
Guillaume Long,0,0,1,1,1
Gulf Cartel,1,0,0,1,1
Haha,0,1,0,1,1
Hall of Famer,0,1,0,1,1
Hall of Famer Joe DiMaggio,0,0,1,1,1
Hall of of Fame,0,0,1,1,1
Harry S. Truman,0,1,0,1,1
Harvard Business Review,0,0,1,1,1
HBCU,0,0,1,1,1
HBO,1,0,0,1,1
Heather Conley,0,0,1,1,1
hedge fund manager,0,1,0,1,1
Hemisferio Occidental,0,0,1,1,1
Henri Bendel,0,0,1,1,1
Here we are,0,0,1,1,1
Hey Jude,0,1,0,1,1
Hezbollah,0,0,1,1,1
Hilary,0,0,1,1,1
Hindu,0,1,0,1,1
Hinsdale Associates,0,1,0,1,1
Hiran,0,0,1,1,1
historiador,0,0,1,1,1
HIV,0,1,0,1,1
Hodgkin,1,0,0,1,1
Hollywood Foreign Press Association,0,1,0,1,1
Holy Roman,0,0,1,1,1
Hotel Internacional,0,1,0,1,1
House of Commons,0,1,0,1,1
Houston George Bush Intercontinental Airport,1,0,0,1,1
Howard Unruh,1,0,0,1,1
http://itunes.com/theaxefiles,0,0,1,1,1
http://podcast.cnn.com,0,0,1,1,1
https://t.co/1nXRUQrnJB,0,0,1,1,1
https://t.co/4ieNcKw5Kt,0,0,1,1,1
https://t.co/4NeukQwYv9,0,0,1,1,1
https://t.co/7rjxnVOch4,0,0,1,1,1
https://t.co/7zXdqDRtid,0,0,1,1,1
https://t.co/eNUNMAL4ji,0,0,1,1,1
https://t.co/h5n7id2DsM,1,0,0,1,1
https://t.co/HndsbVbRer,0,0,1,1,1
https://t.co/MZU30SlfGK,0,1,0,1,1
https://t.co/orm06j8dIG,0,0,1,1,1
https://t.co/PaLvJDvDbl,0,1,0,1,1
https://t.co/T8H5mi8SVd,0,0,1,1,1
https://t.co/Uq8y1RoiBM,0,0,1,1,1
https://t.co/UxoekzLwx5,0,1,0,1,1
Hubbard,0,1,0,1,1
Huffington Post,0,0,1,1,1
Hugo Spadafora,1,0,0,1,1
Human Development Index,0,0,1,1,1
Humberto Mora Ochoa,1,0,0,1,1
I Want to Hold Your Hand,0,0,1,1,1
Ibrahim Boubacar Keita,1,0,0,1,1
Ibtihaj Muhammad,0,0,1,1,1
Idaho Democratic Party,0,0,1,1,1
IHS Global Insight,0,0,1,1,1
Illinois AG,1,0,0,1,1
illiquid,0,0,1,1,1
I'm proud,0,1,0,1,1
Imbabura,0,1,0,1,1
Inauguration,0,1,0,1,1
Independent Group,1,0,0,1,1
Independent Police Review Authority,1,0,0,1,1
Indian subcontinent,0,1,0,1,1
Indonesian,1,0,0,1,1
Indri,0,0,1,1,1
information management director,0,0,1,1,1
Institute of International Studies,0,1,0,1,1
Instituto Broad,0,1,0,1,1
Instituto Fisher de Estudios Estratégicos,0,0,1,1,1
Intelligence and Security Committee,0,1,0,1,1
Interagency Task Force,1,0,0,1,1
Inter-American Dialogue,0,0,1,1,1
Interior Minister,1,0,0,1,1
Interior secretary nominee,1,0,0,1,1
Ipsos,0,0,1,1,1
IRS,0,0,1,1,1
Irvine (California),0,1,0,1,1
Israeli Defense Minister,0,0,1,1,1
italiana,0,0,1,1,1
Iván Rodriguez,0,0,1,1,1
Iván Velázquez,0,1,0,1,1
Ivana Kottasova,0,1,0,1,1
IVZ,0,1,0,1,1
J.,0,0,1,1,1
Jack McFarland,1,0,0,1,1
Jackie Evancho,0,1,0,1,1
Jacksonians,0,0,1,1,1
Jacqueline Howard,0,0,1,1,1
Jaime Harrison,0,0,1,1,1
Jaime Rodríguez,0,1,0,1,1
"Jalisco, Mexico",1,0,0,1,1
"Jamaica, New York",0,1,0,1,1
James Baker III,0,0,1,1,1
James Burrows,0,0,1,1,1
Jamie Gangel,0,0,1,1,1
Jan. 1,1,0,0,1,1
"Jan. 2, 2012",0,1,0,1,1
"January 18th, 2017",0,0,1,1,1
Janus,1,0,0,1,1
jardinero,0,1,0,1,1
Jason Kravarik,1,0,0,1,1
Jay Croft,0,0,1,1,1
jefe de Servicios de Emergencia,0,0,1,1,1
jefe del sindicato,0,0,1,1,1
Jehmu Greene,0,0,1,1,1
Jennifer Agiesta,0,1,0,1,1
Jennifer Granholm,0,0,1,1,1
Jericho Oil Corp.,0,1,0,1,1
Jerusalén,0,0,1,1,1
Jerusalem Post,0,0,1,1,1
Jesus,0,0,1,1,1
Jew,0,1,0,1,1
JFK,0,1,0,1,1
Jill Disis,1,0,0,1,1
Jim Wormington,0,0,1,1,1
"Jim"" Delligatti",0,0,1,1,1
Joaquín Archivaldo Guzmán Loera,0,0,1,1,1
John Cornyn,1,0,0,1,1
John Couwels,0,0,1,1,1
John Cryan,1,0,0,1,1
John Czwartacki,0,0,1,1,1
John D. Sutter,0,0,1,1,1
JOHN DEFTERIOS,0,0,1,1,1
John Kirby,1,0,0,1,1
John Landgraf,1,0,0,1,1
John Lennon,0,0,1,1,1
John Oliver,1,0,0,1,1
John Quincy Adams,0,1,0,1,1
John Stremlau,0,1,0,1,1
John Thune,0,0,1,1,1
John Waller,0,0,1,1,1
Jon Favreau,0,0,1,1,1
Jon Lovett,0,0,1,1,1
Jon Ostrower,0,1,0,1,1
Joseph Lambert,1,0,0,1,1
Joshua Berlinger,1,0,0,1,1
Journal of the American Medical Association,0,1,0,1,1
Journalist,0,0,1,1,1
JP Morgan,0,0,1,1,1
JP Morgan ( JPM,0,0,1,1,1
Juan Jesús Posadas Ocampa,1,0,0,1,1
Julien Barnes-Dacey,0,0,1,1,1
Julio Berrios,0,0,1,1,1
junio,0,1,0,1,1
Justin Hartley,0,0,1,1,1
Kara Fox,0,0,1,1,1
Karen Hughes,0,1,0,1,1
Karen Pence,0,1,0,1,1
Karen Walker,1,0,0,1,1
Karl Rove,0,1,0,1,1
Kate del Castillo,0,0,1,1,1
Kate Maltby,1,0,0,1,1
Kathryn Vasel,0,0,1,1,1
Katie Glaeser,0,1,0,1,1
Katie Lobosco,1,0,0,1,1
Kazakhstan,1,0,0,1,1
Keith Allen,0,0,1,1,1
Kentucky plant,0,0,1,1,1
Ki Fanning,1,0,0,1,1
Kia,0,0,1,1,1
Kilamba Kaixi,0,0,1,1,1
Knesset,0,0,1,1,1
KPC,0,0,1,1,1
KT McFarland,0,0,1,1,1
KTRK,0,0,1,1,1
"La Tuna, Badiraguato, Sinaloa, Mexico",1,0,0,1,1
labor secretary under,0,0,1,1,1
Lady,0,1,0,1,1
Lake Huron,0,0,1,1,1
Lankov,1,0,0,1,1
Laquan McDonald,1,0,0,1,1
Last Week Tonight,1,0,0,1,1
Latinoamérica,0,0,1,1,1
Lauren del Valle,0,0,1,1,1
Lee Kun-hee,0,0,1,1,1
Leron Lee,0,0,1,1,1
Lesley Stahl,0,1,0,1,1
Leslie Miley,1,0,0,1,1
Leticia Guevara-Cuence,1,0,0,1,1
"Lewis, Mexico",0,1,0,1,1
LGBT,1,0,0,1,1
Liberal,0,0,1,1,1
Liberian,0,1,0,1,1
Libertarian,0,0,1,1,1
Liberty,0,1,0,1,1
Liberty Ball,0,0,1,1,1
lieutenant,0,0,1,1,1
Lieutenant Governor,1,0,0,1,1
lieutenants,1,0,0,1,1
Lincoln Bible,0,1,0,1,1
Lincoln MKC,1,0,0,1,1
"Lincoln, Jefferson",1,0,0,1,1
Lindsey Graham,0,1,0,1,1
Lloyd's of London,0,0,1,1,1
LMT,1,0,0,1,1
loan servicer,0,0,1,1,1
Lockheed Martin,0,1,0,1,1
Lolita,0,1,0,1,1
London School of Economics,0,0,1,1,1
"London, England",0,0,1,1,1
Looking,0,1,0,1,1
"Los Mochis, Sinaloa",0,1,0,1,1
Louis Farrakhan,0,1,0,1,1
Love is Love,0,1,0,1,1
LSU Health,0,1,0,1,1
Lt. Gov.,0,1,0,1,1
LTC,0,1,0,1,1
Luba Samri,1,0,0,1,1
Luis Gutiérrez,0,1,0,1,1
México),1,0,0,1,1
magistrado,0,1,0,1,1
Magistrate Judge,1,0,0,1,1
Maine,0,1,0,1,1
Major League Baseball,0,1,0,1,1
Make America Great Again Party,0,1,0,1,1
Make America Great Again' Party,0,1,0,1,1
Malagasy,0,0,1,1,1
Malcolm Beith,0,0,1,1,1
Malian military,0,0,1,1,1
Mandela,0,0,1,1,1
Manu,1,0,0,1,1
Mar de China Meridional,0,0,1,1,1
María Consuelo Loera Pérez,0,1,0,1,1
María Teresa Arnal,0,1,0,1,1
Marcha de Mujeres,0,1,0,1,1
Margaret Huang,0,0,1,1,1
Marie Danziger,0,0,1,1,1
Marietta Daily Journal,0,0,1,1,1
Mark Burnett,1,0,0,1,1
Mark Cunningham,0,0,1,1,1
Mark Fields,0,1,0,1,1
Marlyn,0,0,1,1,1
martes 17 de enero,1,0,0,1,1
Mary Fallin,0,1,0,1,1
Massive Blaze,0,0,1,1,1
Match.com,0,0,1,1,1
Matt Palmquist,1,0,0,1,1
Mauritanian,1,0,0,1,1
Max Mutchnick,0,0,1,1,1
Maxim Oreshkin,0,0,1,1,1
"Mazatlán, Mexico",0,1,0,1,1
MBA,0,0,1,1,1
MCD,0,0,1,1,1
McDonald,1,0,0,1,1
MCO,1,0,0,1,1
Medellin cartel,1,0,0,1,1
medio día,0,0,1,1,1
medio siglo,1,0,0,1,1
mediodía,0,0,1,1,1
Meet The Press,1,0,0,1,1
Melania,0,1,0,1,1
"Mendham, New Jersey",0,1,0,1,1
Metro,0,0,1,1,1
Metro Houston,0,0,1,1,1
Metropolitan Police Department,0,0,1,1,1
Mexican Senate,0,0,1,1,1
Michael,0,0,1,1,1
Michael Brune,0,0,1,1,1
Michael Deaver,0,0,1,1,1
Michael Morell,0,0,1,1,1
Michigan Department of Environmental Quality,1,0,0,1,1
Mick Jagger,0,1,0,1,1
Micky Rosenfeld,0,0,1,1,1
Microsoft Theater,1,0,0,1,1
Midazolam,1,0,0,1,1
middle bun,1,0,0,1,1
Midway,0,0,1,1,1
Migration Policy Institute,1,0,0,1,1
Miguel Dorantes Mesa,0,0,1,1,1
Mike Allen,0,1,0,1,1
Minister of Agriculture,0,0,1,1,1
ministro de Economía,0,0,1,1,1
Ministro de Economía de Argentina,0,0,1,1,1
Ministry of Economy,1,0,0,1,1
"Miramar, Florida",0,0,1,1,1
Miss Universo,0,0,1,1,1
MJ Lee,0,0,1,1,1
MLB Network,0,0,1,1,1
Mohammad Baqer Ghaliba,0,0,1,1,1
Moldavia,0,1,0,1,1
"Mon December 12, 2011",0,0,1,1,1
"Monday, February 13",0,0,1,1,1
"Monday, January 23",0,0,1,1,1
"Monday, January 9",0,0,1,1,1
Mong Palatino,0,0,1,1,1
Montana Attorney General,0,1,0,1,1
"Montgomery, Alabama",0,0,1,1,1
Moon Hyung-pyo,1,0,0,1,1
Mormon Tabernacle Choir,0,0,1,1,1
Mount Vernon Square,0,0,1,1,1
Mr. President-elect,0,0,1,1,1
MS,1,0,0,1,1
MTV,0,1,0,1,1
Mulvaney,0,0,1,1,1
Muriel Bowser,0,0,1,1,1
myelin,1,0,0,1,1
Nadella,0,1,0,1,1
Nancy Hollander,0,0,1,1,1
Nashville,0,1,0,1,1
Natalie Ravitz,0,1,0,1,1
Nate Silver,0,1,0,1,1
Nation of Islam,0,0,1,1,1
National Building Museum,0,1,0,1,1
National Institutes of Alcohol Abuse and Alcoholism,0,1,0,1,1
National Intelligence,0,1,0,1,1
National League,0,1,0,1,1
National Mall,0,1,0,1,1
National Park Service,0,0,1,1,1
National Portrait Gallery,0,1,0,1,1
National Press Club,0,1,0,1,1
National Review,0,0,1,1,1
National Rifle Association,0,1,0,1,1
National Slavery and Human Trafficking Prevention Month,0,1,0,1,1
Nationals,0,1,0,1,1
NATO alliance,0,0,1,1,1
NAVI,0,1,0,1,1
Navy,0,1,0,1,1
NBCU Photo Bank,0,1,0,1,1
NCIS,0,1,0,1,1
Neil Cavuto,1,0,0,1,1
Neuroscience Center of Excellence,0,0,1,1,1
New Day,0,0,1,1,1
New Hampshire state chair,0,0,1,1,1
New Hope Fertility Center,1,0,0,1,1
New Mexico,0,0,1,1,1
new Silk Road,0,0,1,1,1
New York Congressman,0,0,1,1,1
New York Hilton Midtown,0,0,1,1,1
New York Post,0,0,1,1,1
New York Times building,0,1,0,1,1
New York Yankees,1,0,0,1,1
Newsmax,1,0,0,1,1
Newtown,0,1,0,1,1
next Monday,1,0,0,1,1
Nicholas,0,0,1,1,1
NICHOLAS KAMM,1,0,0,1,1
Nicolas Bazan,0,1,0,1,1
Nielsen ratings,0,1,0,1,1
Nikolas Cruz,1,0,0,1,1
NKE,0,0,1,1,1
NLCS MVP,0,1,0,1,1
nominee,0,1,0,1,1
nominee for energy secretary,0,1,0,1,1
nominee for secretary of state,0,1,0,1,1
North African,0,0,1,1,1
North American,1,0,0,1,1
North Carolina A&T University,0,1,0,1,1
NorthShore Neurological Institute,0,0,1,1,1
NSC,1,0,0,1,1
O Lord,0,0,1,1,1
دكار,1,0,0,1,1
أستاذ العلوم السياسية,0,0,1,1,1
إفريقيا,0,0,1,1,1
إفريقية,0,1,0,1,1
اسماعيل عزّام,0,0,1,1,1
الأمم المتحدة,0,1,0,1,1
الإفريقية,1,0,0,1,1
الرباط,0,1,0,1,1
الثلاثاء,0,1,0,1,1
الاثنين,1,0,0,1,1
الاتحاد القاري,0,1,0,1,1
الصحراوية,0,1,0,1,1
العثماني,0,0,1,1,1
السنغالية,1,0,0,1,1
المصرية,1,0,0,1,1
المغربية,1,0,0,1,1
المحكمة الإدارية العليا,1,0,0,1,1
المحكمة الادارية العليا,0,1,0,1,1
المملكة العربية السعودية,0,0,1,1,1
المنظمة القارية,1,0,0,1,1
المكتب التنفيذي,0,1,0,1,1
الفقيه,0,0,1,1,1
جبهة البوليساربو,0,1,0,1,1
جمهورية,0,0,1,1,1
سعد الدين العثماني,0,1,0,1,1
Obamacare,1,0,0,1,1
Océano Pacífico,0,0,1,1,1
Office Department of Corrections,0,0,1,1,1
Office of Government,1,0,0,1,1
Office of the Comptroller of the Currency,1,0,0,1,1
Oficina Meteorológica de Reino Unido,0,0,1,1,1
Oil,1,0,0,1,1
Oklahoma Oil & Gas Association,0,1,0,1,1
Oklahoma Oil and Gas Association,0,1,0,1,1
Oklahoma State Senate,1,0,0,1,1
Oklahoma State University,1,0,0,1,1
Oklahoma Supreme Court,1,0,0,1,1
Olhansky,0,0,1,1,1
Omar Schoijet,0,1,0,1,1
Omar Vizquel,0,0,1,1,1
One Belt One Road,0,0,1,1,1
One China,0,1,0,1,1
One day,0,0,1,1,1
one month,0,1,0,1,1
One month,0,1,0,1,1
حزب العدالة والتنمية,0,1,0,1,1
OPD,0,1,0,1,1
Oprah,1,0,0,1,1
Ora TV y Uno Noticias,0,1,0,1,1
Orange County,0,0,1,1,1
Orange County Sheriff's Office,1,0,0,1,1
Organización Mundial Meteorológica,1,0,0,1,1
Oriente Medio,0,1,0,1,1
Orin Hatch,1,0,0,1,1
Orrin Hatch,0,0,1,1,1
Orthodox,0,1,0,1,1
Oscars,1,0,0,1,1
O'Shares Exchange Traded Funds,0,1,0,1,1
OTT,1,0,0,1,1
Pa. Delligatti,1,0,0,1,1
Pablo Escobar,1,0,0,1,1
Pacific Partnership,0,1,0,1,1
Pacto de Varsovia,0,0,1,1,1
Palacio de Miraflores,0,0,1,1,1
Palacio Presidencial,0,0,1,1,1
Palestinian state,0,0,1,1,1
Palladium,0,1,0,1,1
"Palm Beach, Florida",0,1,0,1,1
"Palm Springs, California",0,0,1,1,1
Pam,0,0,1,1,1
Panama Canal,0,0,1,1,1
Parashuram Singh,1,0,0,1,1
Park County School District No. 6,0,0,1,1,1
Parson,1,0,0,1,1
Participant Media,1,0,0,1,1
Partido independentista puertorriqueño,0,1,0,1,1
patriota,0,1,0,1,1
Patty Murray,0,1,0,1,1
Peña Nieto,0,0,1,1,1
Pearsons,0,0,1,1,1
PED,0,1,0,1,1
Pennsylvania Avenue,0,1,0,1,1
People List,0,1,0,1,1
Permian Basin of Texas,0,0,1,1,1
personal secretary,0,0,1,1,1
peruana,0,0,1,1,1
Peter Thiel,0,1,0,1,1
Pew Research,0,0,1,1,1
Pew Research Center,0,0,1,1,1
Philip Schuyler,1,0,0,1,1
Philippine,0,1,0,1,1
PIB,1,0,0,1,1
PIB per cápita,1,0,0,1,1
pic.twitter.com/5LRpx8smwq,0,0,1,1,1
pic.twitter.com/7HvxJnbXcH,0,0,1,1,1
pic.twitter.com/91Y3czJJ6e,0,0,1,1,1
pic.twitter.com/9J5kkWLVST,0,0,1,1,1
pic.twitter.com/bt4wOHFL1z,0,1,0,1,1
pic.twitter.com/bUEh5wc3r2,0,0,1,1,1
pic.twitter.com/CXgAsJVAuO,0,1,0,1,1
pic.twitter.com/j9CQhRmxhm,0,0,1,1,1
pic.twitter.com/LUB0DnM4RU,0,0,1,1,1
pic.twitter.com/pahEydkZ5Z,0,0,1,1,1
pic.twitter.com/PcQrgK2SI3,0,1,0,1,1
pic.twitter.com/pOJpqvTbPH,0,1,0,1,1
pic.twitter.com/SVjFUEvNak,0,0,1,1,1
pic.twitter.com/uaAn6j8Ygy,0,0,1,1,1
pic.twitter.com/wugfY0Ud76,1,0,0,1,1
pic.twitter.com/x3zDW6TRSr,0,0,1,1,1
Pinterest,0,1,0,1,1
Plascokar,0,1,0,1,1
Playa del Carmen,0,1,0,1,1
Policía Cibernética,0,1,0,1,1
police commissioner and Chief,0,0,1,1,1
police Lt.,0,0,1,1,1
pollster and strategist,1,0,0,1,1
Pollyanna,1,0,0,1,1
"Prague, Oklahoma",0,0,1,1,1
Pres Secretary,0,1,0,1,1
PRESIDENT,1,0,0,1,1
Presidente,1,0,0,1,1
presidente de Rusia,0,0,1,1,1
President-Elect,0,1,0,1,1
President-elect Almighty,0,0,1,1,1
presidents-elect,1,0,0,1,1
press corps,0,1,0,1,1
Press Secretary,0,1,0,1,1
Press TV,1,0,0,1,1
Prince Foundation,1,0,0,1,1
Proceedings of the National Academy,0,0,1,1,1
Procter & Gamble,0,0,1,1,1
Procuraduría General de México,0,0,1,1,1
profesor,0,0,1,1,1
PT,0,0,1,1,1
public emergency,0,1,0,1,1
Public Security Minister,1,0,0,1,1
Publicidad,0,0,1,1,1
Publicidad y Contenido Editorial,0,0,1,1,1
Pudge,0,0,1,1,1
Puente Grande,1,0,0,1,1
Puerto Vallarta,1,0,0,1,1
Pulitzer,0,1,0,1,1
Quarterback,1,0,0,1,1
quinto año,0,1,0,1,1
Radio City Rockettes,0,0,1,1,1
RAI,0,1,0,1,1
railroad Union Pacific,0,0,1,1,1
Raju,1,0,0,1,1
Ralph Lauren,1,0,0,1,1
Ramón Lecumberri,1,0,0,1,1
Randy,1,0,0,1,1
Rangers,0,0,1,1,1
rapper,0,1,0,1,1
Read,0,1,0,1,1
ReadySet,1,0,0,1,1
Reed Hastings,0,0,1,1,1
Refinery29,1,0,0,1,1
Refinery29 Clinton,0,0,1,1,1
Renda St. Clair,0,0,1,1,1
República Islámica de Irán,0,0,1,1,1
Republican National Convention,0,1,0,1,1
Republican People's party,0,1,0,1,1
Reshma Saujani,0,0,1,1,1
Resource Conservation,0,1,0,1,1
Retired Gens,0,1,0,1,1
Reunion Island,0,0,1,1,1
Reuters,0,0,1,1,1
Reynolds American,0,1,0,1,1
Rice University,1,0,0,1,1
Richard Cordray,1,0,0,1,1
Richard Doubtfire,0,0,1,1,1
Rick Santorum,0,0,1,1,1
Rishi Iyengar,0,0,1,1,1
RNC Chair Reince Priebus,0,1,0,1,1
Robert Barro,0,0,1,1,1
Robert Greenblatt,0,1,0,1,1
Robert Isom,0,0,1,1,1
Robert Mclean,1,0,0,1,1
Rodolfo del Ángel Campos,0,0,1,1,1
Roger Ailes,1,0,0,1,1
Rolling Stone,0,0,1,1,1
Ron Chernow,0,1,0,1,1
Rosa Elena Heredia Mendoza,0,0,1,1,1
Ross,0,1,0,1,1
RTS,0,1,0,1,1
Rubén Berrios,0,1,0,1,1
rusos,0,1,0,1,1
Russian Arctic,0,1,0,1,1
Russian military,0,0,1,1,1
Rust Belt,1,0,0,1,1
séptimo mes,1,0,0,1,1
Sabine River,0,1,0,1,1
Sacramento,0,1,0,1,1
Safra Catz,0,1,0,1,1
Salón de la Fama del béisbol,0,0,1,1,1
Salena Zito,0,0,1,1,1
sales manager,0,0,1,1,1
Sally Boynton Brown,0,0,1,1,1
Sammy Morales,0,0,1,1,1
Samsung Electronics,0,1,0,1,1
Samuel Alito,0,1,0,1,1
San Francisco Giants,0,1,0,1,1
Sanaa,0,0,1,1,1
Santo Tomé y Príncipe,1,0,0,1,1
Sara Ashley O'Brien,0,1,0,1,1
Sara Ganim,0,0,1,1,1
Satish Pal,1,0,0,1,1
"Saturday, December 10",0,0,1,1,1
"Saturday, January 21, 2017",0,1,0,1,1
"Saturday, November 19",0,0,1,1,1
Saudis,1,0,0,1,1
School of Economic,0,0,1,1,1
Scott Israel,1,0,0,1,1
Scottish National Party,0,1,0,1,1
Screen Actors Guild,0,1,0,1,1
señor presidente,0,0,1,1,1
seafreight director,0,0,1,1,1
Seúl,0,0,1,1,1
second-year,1,0,0,1,1
Secretaría de Salud,0,0,1,1,1
Secretaría de Salud de Veracruz,0,0,1,1,1
secretario de Educación,0,1,0,1,1
secretario de gobernación,0,1,0,1,1
secretario de Salud,0,1,0,1,1
secretario de Seguridad Pública,1,0,0,1,1
secretario de Unasur,0,0,1,1,1
Secretary nominee,0,1,0,1,1
secretary nominee Rep.,0,1,0,1,1
Secretary of Agriculture,0,1,0,1,1
Secretary of Defense,0,1,0,1,1
Secretary of Homeland Security,0,1,0,1,1
secretary of homeland security nominee,0,0,1,1,1
Secretary of Transportation,0,1,0,1,1
seis días,1,0,0,1,1
Self-compassion,0,1,0,1,1
Senate Armed Services Committee,0,1,0,1,1
Senate Committee of Banking,0,0,1,1,1
Senate Environmental and Public Works Committee,1,0,0,1,1
Senate Foreign Relations Committee,0,0,1,1,1
Senate Foreign Relations committee,0,0,1,1,1
Senate HELP Committee,0,0,1,1,1
senior director of applied research,0,1,0,1,1
senior vice president of communications,1,0,0,1,1
Sens.,0,1,0,1,1
Seoul,0,0,1,1,1
Seoul Central District Court,0,0,1,1,1
septiembre de 2015,0,0,1,1,1
Sergey Lavrov,0,1,0,1,1
Servicios de Emergencia,0,1,0,1,1
Servicios de Salud,1,0,0,1,1
Shelby Sever,1,0,0,1,1
Sheryl Sandberg,0,1,0,1,1
Shia,1,0,0,1,1
Shirzad Bozorgmehr,0,0,1,1,1
Sinaloa Cartel Pacific,0,0,1,1,1
singer,0,1,0,1,1
singer songwriter,0,0,1,1,1
Site Map,1,0,0,1,1
Sitora Yusufiy,1,0,0,1,1
Slim,0,0,1,1,1
SLM,0,0,1,1,1
SNE,0,0,1,1,1
"South Bend, Indiana",0,1,0,1,1
Southeast Asian,0,1,0,1,1
Southwest,0,0,1,1,1
"Spartanburg, S.C.",0,0,1,1,1
speaker,0,1,0,1,1
special assistant,0,1,0,1,1
Sports Illustrated,0,0,1,1,1
Sr.,1,0,0,1,1
staff speechwriter,0,0,1,1,1
Star Gate,0,0,1,1,1
STAT News,1,0,0,1,1
state Attorney General,1,0,0,1,1
State department,0,1,0,1,1
state insurance commissioner,0,1,0,1,1
Stephanie Smith,0,1,0,1,1
Stephen Collinson,0,1,0,1,1
Stephen Miller,1,0,0,1,1
Stephen Pifer,0,0,1,1,1
Steve Daines,0,1,0,1,1
Steve Israel,0,0,1,1,1
Steve Mnuchin,0,0,1,1,1
Stimson Center,0,1,0,1,1
Strawberry,0,1,0,1,1
Stuart Gulliver,0,0,1,1,1
student,0,0,1,1,1
Sudán,1,0,0,1,1
Sudamérica,1,0,0,1,1
Sugam Pokharel,1,0,0,1,1
Sun,0,1,0,1,1
Sunjin Cha,0,1,0,1,1
Susan,0,0,1,1,1
Susan Collins,0,1,0,1,1
Susannah Cullinane,0,0,1,1,1
Suzanne Frederick,1,0,0,1,1
Swamp Cabinet,1,0,0,1,1
Sweden,1,0,0,1,1
T. Mnuchin Inc.,1,0,0,1,1
Taiwán,0,0,1,1,1
"Tampa, Florida",1,0,0,1,1
tan Rottweiler,0,1,0,1,1
Tax Policy Center,0,1,0,1,1
Taylor Swift,0,0,1,1,1
Tecnológico de Monterrey,0,0,1,1,1
Ted Barrett,0,1,0,1,1
Telemundo,0,0,1,1,1
Television Critics Association Winter Press,0,0,1,1,1
Ten days,0,1,0,1,1
Ten-second,1,0,0,1,1
terrorist analyst,0,0,1,1,1
Terry Szuplat,0,0,1,1,1
Tesora,0,0,1,1,1
The American Interest,0,0,1,1,1
The Apprentice,0,1,0,1,1
The Daily Caller,1,0,0,1,1
The Emoji Code,0,0,1,1,1
The fear,0,1,0,1,1
The Federalist Papers,0,0,1,1,1
The Journal Record,0,0,1,1,1
The Piano Guys,0,0,1,1,1
The Political Economy of Labor,0,1,0,1,1
The Revs,0,0,1,1,1
The Simpsons,0,1,0,1,1
The Times of Israel,1,0,0,1,1
The Tonight Show,0,0,1,1,1
This Council,0,1,0,1,1
this January,0,0,1,1,1
this Thursday,0,1,0,1,1
This Week,1,0,0,1,1
Thom Patterson,0,0,1,1,1
three-hour,1,0,0,1,1
Thune,0,0,1,1,1
"Thursday, December 1",1,0,0,1,1
"Thursday, December 15",0,1,0,1,1
"Thursday, December 22",0,0,1,1,1
"Thursday, December 8",0,1,0,1,1
"Thursday, February 16",0,0,1,1,1
"Thursday, February 9",0,1,0,1,1
"Thursday, March 2",0,0,1,1,1
"Thursday, November 10",0,0,1,1,1
Tibetan,0,1,0,1,1
Tigers,0,1,0,1,1
Tim Fox,0,1,0,1,1
Tim Skoczek,0,1,0,1,1
Time for news,0,1,0,1,1
Times,0,0,1,1,1
Title IX,1,0,0,1,1
Tocumen International Airport,0,0,1,1,1
Todd Hiett,0,0,1,1,1
"Toluca, Mexico",1,0,0,1,1
Tom Daschle,0,1,0,1,1
Tom Kludt,0,0,1,1,1
Tom LoBianco,1,0,0,1,1
Tom Verducci,0,0,1,1,1
Tommy Vietor,0,0,1,1,1
Tony Awards,0,1,0,1,1
Toronto Star,0,0,1,1,1
Tory,1,0,0,1,1
Toyota,0,1,0,1,1
trade minister,0,1,0,1,1
Tratado de Asociación Pacifico,1,0,0,1,1
Travis Hoium,0,0,1,1,1
Treasury and Labor,0,1,0,1,1
Treasury Department and Labor,1,0,0,1,1
Treasury note,0,1,0,1,1
Treasury yields,0,0,1,1,1
tres horas,0,0,1,1,1
tres meses,0,0,1,1,1
tres semana,0,1,0,1,1
tres semanas,0,1,0,1,1
Trump Commerce,0,0,1,1,1
Trump Por David Cox,0,0,1,1,1
Trumpian America,1,0,0,1,1
Try to remember,1,0,0,1,1
TTP,1,0,0,1,1
Tucker Carlson,0,0,1,1,1
"Tuesday, December 13",0,1,0,1,1
"Tuesday, December 6",0,1,0,1,1
"Tuesday, February 14",0,0,1,1,1
"Tuesday, February 28",0,0,1,1,1
"Tuesday, February 7",1,0,0,1,1
"Tuesday, January 10",0,1,0,1,1
"Tuesday, January 31",0,0,1,1,1
"Tuesday, November 22",0,0,1,1,1
"Tuesday, November 29",0,0,1,1,1
Turquía,1,0,0,1,1
TV director,0,0,1,1,1
Twitter México,0,1,0,1,1
Two hours,1,0,0,1,1
two-hour,1,0,0,1,1
two-minute,1,0,0,1,1
Two-year,0,0,1,1,1
two-year,1,0,0,1,1
U.N. General Assembly,0,0,1,1,1
U.S,0,0,1,1,1
U.S. Advisory Council on Human Trafficking,0,1,0,1,1
U.S. auto industry,1,0,0,1,1
U.S. Capitol building,0,0,1,1,1
U.S. Department of Energy,0,1,0,1,1
قيه,1,0,0,1,1
لاتحاد الإفريقي,0,1,0,1,1
لمغرب,0,0,1,1,1
مجلس التنمية,1,0,0,1,1
مجلس التنمية الاقتصادية,1,0,0,1,1
مختبر الدراسات الدولية,1,0,0,1,1
مصرية,0,0,1,1,1
مستشار,1,0,0,1,1
مستشاري,1,0,0,1,1
نوفمبر,1,0,0,1,1
فرنسا,1,0,0,1,1
فيينا,0,0,1,1,1
UAL,1,0,0,1,1
UFO,1,0,0,1,1
Ukraine Association for Reproductive Medicine,0,1,0,1,1
un día,0,0,1,1,1
Uncle Sam,1,0,0,1,1
Unidad de Amiloidosis,0,0,1,1,1
United Technologies,0,0,1,1,1
Universe,0,1,0,1,1
Universidad Bangor,0,0,1,1,1
Universidad Edge Hill,0,0,1,1,1
Universidad Johns Hopkins,0,0,1,1,1
Universidad Kookmin,0,0,1,1,1
University of British Columbia,0,0,1,1,1
University of California's Korean Studies Institute,1,0,0,1,1
University of Colorado Anschutz Medical Campus,0,0,1,1,1
University of Florida College of Medicine,0,0,1,1,1
University of Illinois at Chicago,0,0,1,1,1
University of Pennsylvania,0,0,1,1,1
University of Tennessee,1,0,0,1,1
University of Texas,0,0,1,1,1
University of the Witwatersrand,0,0,1,1,1
UNP,0,1,0,1,1
Urban Affairs,0,0,1,1,1
Uri Ariel,0,0,1,1,1
US Geological Study,0,0,1,1,1
US Strategic Command,0,0,1,1,1
USA Network,0,0,1,1,1
يارمو كوتيلين,1,0,0,1,1
Utah,0,0,1,1,1
UTX,0,0,1,1,1
Valley Elementary,0,1,0,1,1
Variety,0,0,1,1,1
Vatican Embassy,0,0,1,1,1
venezolana,1,0,0,1,1
Verreaux,0,1,0,1,1
Vice-President elect,0,1,0,1,1
Victim Assistance Database,1,0,0,1,1
Vito Maggiolo,0,0,1,1,1
Vonne Hutchinson,1,0,0,1,1
W. Bellfort,1,0,0,1,1
Walter E. Washington,0,1,0,1,1
Washington Examiner,0,0,1,1,1
Washington police,0,1,0,1,1
Washington's aide-de-camp,0,0,1,1,1
Washoe County,0,0,1,1,1
Waterford crystal,0,1,0,1,1
WBAY,1,0,0,1,1
WDIV,0,1,0,1,1
"Wednesday, December 14",0,1,0,1,1
"Wednesday, December 21",1,0,0,1,1
"Wednesday, December 28",0,1,0,1,1
"Wednesday, February 1",0,0,1,1,1
"Wednesday, February 14",1,0,0,1,1
"Wednesday, January 25",0,0,1,1,1
"Wednesday, March 1",0,0,1,1,1
"Wednesday, November 9",0,1,0,1,1
Wells Fargo,0,1,0,1,1
Wesley Lowery,0,0,1,1,1
"West Allis, Wisconsin",0,0,1,1,1
Westminster,0,1,0,1,1
WFC,1,0,0,1,1
WGA,0,1,0,1,1
Which side,0,1,0,1,1
Whiskey Rebellion,0,0,1,1,1
White House Press Corps,0,0,1,1,1
White House Press Office,0,0,1,1,1
White's Foodliner,1,0,0,1,1
Whitney Houston,0,0,1,1,1
Wikileaks cables,0,0,1,1,1
Will Truman,0,1,0,1,1
William Hanage,0,0,1,1,1
William Reinsch,1,0,0,1,1
Wintergreen Advisers,1,0,0,1,1
WISN,0,0,1,1,1
WJLA,0,0,1,1,1
WMT,0,1,0,1,1
Women's March,0,0,1,1,1
www.katemaltby.com,0,1,0,1,1
Xavier University,0,1,0,1,1
XOM,1,0,0,1,1
Yair Maayan,0,0,1,1,1
Yale Program on Climate Change Communication,0,0,1,1,1
Yellowstone National Park,0,0,1,1,1
Yemen,1,0,0,1,1
Yvette Williams,1,0,0,1,1
Zarghee Mayan,1,0,0,1,1
Abdullah Mustafa,0,0,1,1,1
ABI Research,0,1,0,1,1
abril de 2018,0,1,0,1,1
Absolute Power,0,1,0,1,1
Acatenango,0,1,0,1,1
Accountability Review Board,1,0,0,1,1
Achim Thoma,1,0,0,1,1
Acting secretary,0,0,1,1,1
Actor,1,0,0,1,1
Actress,1,0,0,1,1
ADA,0,0,1,1,1
Adam Szubin,1,0,0,1,1
ADDDF,1,0,0,1,1
administrative staffer,0,1,0,1,1
Aerion,0,0,1,1,1
Aerocivil,0,1,0,1,1
aeropuerto de Zurich,1,0,0,1,1
"Aeroservices, Inc.",0,1,0,1,1
African Union,1,0,0,1,1
Agenda 2030,0,0,1,1,1
Agriculture Secretary,0,0,1,1,1
Aguascalientes-Nayarit,0,0,1,1,1
aI,0,0,1,1,1
Aiden,0,0,1,1,1
Ain't I a Woman,0,1,0,1,1
airline Emirates,1,0,0,1,1
Airstream,0,0,1,1,1
Akashi Kaikyō Bridge,0,0,1,1,1
Akashi Strait,1,0,0,1,1
Al Qaida,0,1,0,1,1
Alamy,0,0,1,1,1
Alan Caslavka,0,1,0,1,1
Alastair Fitzpayne,1,0,0,1,1
Alberto Fujimori,0,0,1,1,1
Alejandra Carvallo,0,1,0,1,1
Alejandro Artopoulos,0,0,1,1,1
"Alexandria, Virginia",0,0,1,1,1
Alexis Hernandez,0,1,0,1,1
Alia Khan,0,1,0,1,1
Alipay,0,0,1,1,1
Allied,0,1,0,1,1
Allyssia Alleyne,0,0,1,1,1
Alma Al Turkmani,0,0,1,1,1
al-Nasr,1,0,0,1,1
Alpha Particle X-Ray Spectrometer,0,0,1,1,1
al-Qa'ida,1,0,0,1,1
ALS,0,0,1,1,1
Alzheimer,1,0,0,1,1
Amanda Jackson,1,0,0,1,1
Amazon Fire,0,1,0,1,1
Amazon Prime Video,0,0,1,1,1
America First,1,0,0,1,1
American Academy of Dermatology,0,0,1,1,1
American Academy of Medical Ethics,1,0,0,1,1
American Association of Suicidology,1,0,0,1,1
American Freedom Defense Initiative,1,0,0,1,1
American Heart Association,0,1,0,1,1
American Renaissance,1,0,0,1,1
America's Health Insurance Plans,1,0,0,1,1
Amy Walter,0,0,1,1,1
Anas al-Dabbashi,0,0,1,1,1
and Wall Street Journal,1,0,0,1,1
Andrea Lo,1,0,0,1,1
Andrew Dice Clay,0,0,1,1,1
Andrew Irvine,0,1,0,1,1
Andrew Lipovsky,0,1,0,1,1
Andrews Air Force Base,0,0,1,1,1
Android TV,0,1,0,1,1
Andy,0,1,0,1,1
Andy Space,0,0,1,1,1
Angela,0,0,1,1,1
Anglo,0,0,1,1,1
Animal Health and Inspection Service,0,0,1,1,1
Animal Health Inspection Service,0,1,0,1,1
Animal Parasitic Diseases Laboratory,0,0,1,1,1
Anna Bahney,0,1,0,1,1
Anne Hathaway,0,1,0,1,1
Anquan Boldin,0,0,1,1,1
Anshu Jamsenpa,0,1,0,1,1
Antoine Crouin,0,0,1,1,1
Antwerp,0,0,1,1,1
API,0,0,1,1,1
AppleTV,0,1,0,1,1
April. 1,0,0,1,1,1
architect,0,1,0,1,1
Ari Caldwell,0,0,1,1,1
Arlanda,0,1,0,1,1
Arlene Foster,1,0,0,1,1
Armed Forces,0,1,0,1,1
Armed Forces of Russia,0,0,1,1,1
Aroldo López,0,0,1,1,1
Arquidiócesis de Filadelfia,0,1,0,1,1
artist,1,0,0,1,1
A's,0,0,1,1,1
Asamblea General,0,0,1,1,1
ASEAN,1,0,0,1,1
"Asheville, North Carolina",1,0,0,1,1
Ashley Killough,0,0,1,1,1
Újbuda-központ,1,0,0,1,1
Asociación Internacional de Transporte Aéreo,0,1,0,1,1
Aspen Institute,1,0,0,1,1
assistant director,0,0,1,1,1
assistant professor of pediatrics,0,0,1,1,1
associate management professor,0,0,1,1,1
associate professor and director of Precision Health,0,0,1,1,1
Associated Press,1,0,0,1,1
Association of American Medical Colleges,1,0,0,1,1
AT&T,0,0,1,1,1
Atika Shubert,0,0,1,1,1
Atmosphere Research Group,0,1,0,1,1
attorney charge,0,0,1,1,1
attorney-client communications,1,0,0,1,1
"Auburn Hills, Michigan",0,0,1,1,1
Augusta Ada,0,0,1,1,1
Aung San Suu Kyi,1,0,0,1,1
Aunty Ayo,1,0,0,1,1
"Aurora, Illinois",1,0,0,1,1
Austin American-Statesman,1,0,0,1,1
Austin Powers,1,0,0,1,1
Aviation Museum,0,1,0,1,1
Avicii,1,0,0,1,1
Avon,0,0,1,1,1
Awaji Island,0,1,0,1,1
Ayesha Durgahee,0,0,1,1,1
Azabu Elementary School,0,0,1,1,1
Azerbaijan,0,0,1,1,1
bahía de Kahopo,0,0,1,1,1
Balatoni,1,0,0,1,1
Balling,0,1,0,1,1
Bambi Eszpresszó,1,0,0,1,1
Ban Ki-moon,0,0,1,1,1
Bangladesh,0,0,1,1,1
Bank Muscat,1,0,0,1,1
Barbara Jones,1,0,0,1,1
Barbra Streisand,0,0,1,1,1
Baselworld,0,1,0,1,1
Bastille,0,1,0,1,1
Battle for the Planet of the Apes,0,1,0,1,1
Baxter,0,0,1,1,1
Bayou,0,1,0,1,1
BBM,0,1,0,1,1
BDS Analytics,0,0,1,1,1
Bea,0,0,1,1,1
Beacon Press,1,0,0,1,1
Beam,0,0,1,1,1
Bear Creek,0,0,1,1,1
Beckham,0,1,0,1,1
Belgrade Fortress,0,1,0,1,1
"Beltsville, Maryland",0,0,1,1,1
Bend,1,0,0,1,1
Benjamin Griveaux,1,0,0,1,1
"Berkeley, Calif.",0,0,1,1,1
Berkshire Hathaway,0,0,1,1,1
Bespoke Investment Group,0,0,1,1,1
BEST,0,0,1,1,1
Bewitched,0,0,1,1,1
Bezos,1,0,0,1,1
Big Falcon Rocket,0,0,1,1,1
BlackBerry Mobile,0,0,1,1,1
Blaise Compaora,1,0,0,1,1
Bloukrans Bridge,0,1,0,1,1
BMO Capital Markets,1,0,0,1,1
Board of Supervisors,1,0,0,1,1
Bob Iger,1,0,0,1,1
Bob Martin,0,0,1,1,1
Bobo-Dioulasso,0,0,1,1,1
Bolanos,0,0,1,1,1
Bolivia,0,1,0,1,1
Bonanza King,0,1,0,1,1
Bonnie Scally,0,0,1,1,1
Boom Supersonic,0,0,1,1,1
Boráros,1,0,0,1,1
Borough President,0,1,0,1,1
Boston Celtics,0,0,1,1,1
Boston University School of Public Health,0,0,1,1,1
Brad Matheney,0,0,1,1,1
Brays Bayou,0,0,1,1,1
Brett Brown,1,0,0,1,1
Breyer,0,1,0,1,1
Brian Roberts,0,0,1,1,1
Brianna Keilar,1,0,0,1,1
Bridget Brundrett,0,0,1,1,1
British Columbia,1,0,0,1,1
British Isles,1,0,0,1,1
BRKB,0,0,1,1,1
Brookings Institution,0,1,0,1,1
Bruno Le Maire,1,0,0,1,1
BT Sport,1,0,0,1,1
Buda Hills,0,0,1,1,1
Buddy,0,0,1,1,1
Buffalo Bills,1,0,0,1,1
Burbank,0,0,1,1,1
Burmese,0,0,1,1,1
Burning Man Project,1,0,0,1,1
Byzantine,0,1,0,1,1
Cámara,0,0,1,1,1
Córdoba,0,0,1,1,1
Cañon City,0,1,0,1,1
CABA,1,0,0,1,1
Cabina Kyoto,1,0,0,1,1
Cablenoticias,0,1,0,1,1
California House,0,1,0,1,1
California law,1,0,0,1,1
Cambodia,0,0,1,1,1
Cambridge Analytica,0,1,0,1,1
campaign manager,1,0,0,1,1
Campaign to Stop Killer Robots,0,1,0,1,1
Campbell Soup Co.,1,0,0,1,1
Campona,0,0,1,1,1
Can,0,1,0,1,1
Canadian Imperial Bank of Commerce,0,0,1,1,1
canadiense,0,1,0,1,1
Cancer Research Foundation,0,0,1,1,1
Cannakale 1915 Bridge,1,0,0,1,1
Cape Canaveral Air Force Station,0,0,1,1,1
Capella Hotel,0,0,1,1,1
Capilano Suspension Bridge Park,1,0,0,1,1
Capital of Culture,1,0,0,1,1
Capitol Police,1,0,0,1,1
Carlyle Group,0,1,0,1,1
Carnegie Mellon,1,0,0,1,1
Carol Cowan,1,0,0,1,1
Caroline Malone,0,0,1,1,1
Carta Democrática Interamericana,0,0,1,1,1
Cartoon Network,0,0,1,1,1
Cartoon Network GO,0,1,0,1,1
Carvel,0,1,0,1,1
Catalonia,1,0,0,1,1
Cataluña,0,0,1,1,1
Catalyst,1,0,0,1,1
Cate Blanchett,0,0,1,1,1
Cavs,1,0,0,1,1
CB Insights,0,1,0,1,1
CCD,1,0,0,1,1
cementerio de Chapecó,1,0,0,1,1
Center for Science,0,0,1,1,1
Center for Strategic and International Studies,0,0,1,1,1
Central,0,0,1,1,1
Central Council of Jews,0,0,1,1,1
Centro de Conservación e Investigación,0,0,1,1,1
Centro de Innovación Pedagógica de Juez,0,0,1,1,1
Centro Penal de Apanteos,1,0,0,1,1
chairman Dr.,0,0,1,1,1
Chairman Rep.,1,0,0,1,1
Chandler Thornton,0,0,1,1,1
Chanel,1,0,0,1,1
"Chappaqua, New York",0,0,1,1,1
CHARLES KUONEN,1,0,0,1,1
Charles Kuonen Suspension Bridge,0,0,1,1,1
Charles Parker,0,0,1,1,1
Charley,0,1,0,1,1
chavismo,1,0,0,1,1
Che Guevara,0,0,1,1,1
Chef,0,1,0,1,1
Chelsea,0,1,0,1,1
Chengdu,0,1,0,1,1
Cherry Garcia,1,0,0,1,1
Chica,1,0,0,1,1
Chicken feet,1,0,0,1,1
Chief Analyst,1,0,0,1,1
Chief Commissioner,1,0,0,1,1
Chief Executive,0,1,0,1,1
Chief Justice,1,0,0,1,1
Chief of Detectives,1,0,0,1,1
chief of medicine,0,0,1,1,1
Chief of staff,0,1,0,1,1
chief of staff to national security adviser,0,1,0,1,1
Chief Privacy Officer,1,0,0,1,1
chief protagonist,1,0,0,1,1
Children's Health Insurance Program,0,0,1,1,1
Chilevisión,1,0,0,1,1
Chiloé,0,0,1,1,1
China Conservation and Research Center,0,0,1,1,1
Chinese Communist Party,0,0,1,1,1
Chinese Foreign Minister,0,0,1,1,1
Chinese Foreign Ministry,1,0,0,1,1
Chinese military,0,0,1,1,1
Chinese Theatre,1,0,0,1,1
Chinese YMCA Secondary School,0,0,1,1,1
Chip,0,1,0,1,1
Chris Gutierrez,0,1,0,1,1
Chris Massie,0,1,0,1,1
Chris Silva,0,1,0,1,1
Christopher,0,1,0,1,1
Christopher Dawson,0,1,0,1,1
Christopher Dominguez,0,0,1,1,1
Christopher Stevens,1,0,0,1,1
Chuck Todd,0,0,1,1,1
Chukwuemeka,1,0,0,1,1
Cillizza,1,0,0,1,1
cinco años,0,0,1,1,1
cinco días,1,0,0,1,1
Ciudad de México,0,0,1,1,1
Cléber Santana,0,0,1,1,1
Clark Goldband,0,0,1,1,1
Cleveland,0,0,1,1,1
Cleveland Cavaliers,1,0,0,1,1
Clinton Washington,0,1,0,1,1
Club for Growth and Heritage Action for America,0,1,0,1,1
CNN Australia affiliate Seven News,1,0,0,1,1
CNN Chile,1,0,0,1,1
CNN Tonight,0,1,0,1,1
cnne.com/chapecoense,0,1,0,1,1
CNNEspanol.com,0,0,1,1,1
coach,0,0,1,1,1
Coach,0,0,1,1,1
Cochabanba,1,0,0,1,1
Colonel Sanders,0,0,1,1,1
Columbia Records,0,0,1,1,1
Columbia University,0,0,1,1,1
Combinator,0,0,1,1,1
Comey,0,0,1,1,1
Comisión de DD.HH,1,0,0,1,1
Comisión Europea,0,1,0,1,1
Comité de Relaciones Exteriores del Senado,0,1,0,1,1
Committee for a Responsible Budget,0,0,1,1,1
Committee on Foreign Investment,1,0,0,1,1
communications director,1,0,0,1,1
Communist Party,0,0,1,1,1
Communist party,0,1,0,1,1
Community College,0,0,1,1,1
Concord Bridge,0,0,1,1,1
Conflicted,1,0,0,1,1
Congolese,0,0,1,1,1
Consejo de Estado de Cuba,0,1,0,1,1
Consejo de Ministros,1,0,0,1,1
Consejo Económico Nacional,0,0,1,1,1
Conservative,0,1,0,1,1
Conservatives,0,1,0,1,1
Cook Political Report,0,0,1,1,1
Coordinadora Nacional para la Reducción de Desastres,0,0,1,1,1
Corbis,0,0,1,1,1
Corning,0,0,1,1,1
Cortana,0,0,1,1,1
Corte Suprema,0,0,1,1,1
Cortesía Jumbo Stay Hotel,0,0,1,1,1
Corumbá,0,0,1,1,1
Costa Rica,0,1,0,1,1
Costa Verde,0,1,0,1,1
counsel,0,0,1,1,1
Countess Lovelace,0,0,1,1,1
County State's Attorney's Office,0,1,0,1,1
Court of Remembrance,0,0,1,1,1
couscous,0,0,1,1,1
CPR,1,0,0,1,1
Craig Melvin,1,0,0,1,1
Creative Commons,0,0,1,1,1
Criminal justice reform,0,1,0,1,1
Cruz Investments and Wealth Management,0,0,1,1,1
cuatro semanas,0,1,0,1,1
Cypress,0,0,1,1,1
"Cypress, Texas",0,0,1,1,1
Dakin Andone,0,0,1,1,1
Dakota del Norte,1,0,0,1,1
Dana Rohrabacher,0,0,1,1,1
Dana Sabraw,0,1,0,1,1
Daniel Nikbakht,0,0,1,1,1
Daniel Ottolia,0,1,0,1,1
Daniel Palmont,1,0,0,1,1
Daniel Shane,0,0,1,1,1
Daniela Patiño,0,1,0,1,1
Danny,0,0,1,1,1
Danny Kirwan,1,0,0,1,1
Danyor Suspension Bridge,0,1,0,1,1
Dardanelles,0,0,1,1,1
Darden,0,1,0,1,1
Darden School of Business,0,0,1,1,1
Darkness,1,0,0,1,1
Daryl Hudeck,0,0,1,1,1
Dave Chappelle,0,0,1,1,1
Dave Close,0,0,1,1,1
Dave Schmerler,0,1,0,1,1
David Dollar,0,0,1,1,1
David Goodall,0,1,0,1,1
David Guetta,0,1,0,1,1
David Humphreys,1,0,0,1,1
David N. Dinkins,0,1,0,1,1
David Sharp,1,0,0,1,1
David Siegel,0,0,1,1,1
David Valadao,1,0,0,1,1
David Wainer,0,1,0,1,1
David Wright,0,0,1,1,1
DB4GT Zagato,0,1,0,1,1
DC United,1,0,0,1,1
DC's Superior Court,0,1,0,1,1
Deák Ferenc Square,1,0,0,1,1
Dean Mize,0,1,0,1,1
Deborah Stone,1,0,0,1,1
Defense Secretary,1,0,0,1,1
Degas,0,0,1,1,1
Delhi,0,0,1,1,1
Delia Gallagher,0,0,1,1,1
Delta Airlines,0,0,1,1,1
demócrata,0,0,1,1,1
Democrat of Virginia,1,0,0,1,1
Democratic Senators,0,0,1,1,1
Denise Morrison,1,0,0,1,1
Dennis Rodman,0,0,1,1,1
Denver District Attorney,1,0,0,1,1
Departamento de Justicia,0,0,1,1,1
Deportes,0,0,1,1,1
Deputy AG Rosenstein,0,0,1,1,1
Deputy Director,1,0,0,1,1
Deputy Education Secretary,0,0,1,1,1
deputy executive associate director,0,0,1,1,1
deputy general Counsel,1,0,0,1,1
Deputy President,1,0,0,1,1
Desayuno Nacional de Oración,0,0,1,1,1
detectives,0,0,1,1,1
Devante Smith-Pelly,0,1,0,1,1
Dianne Feinstein,0,1,0,1,1
diciembre de 1968,0,1,0,1,1
Dick Shelby,0,0,1,1,1
Diderot High School,0,0,1,1,1
Dine,0,0,1,1,1
Dinesh D'Souza,0,1,0,1,1
diputada laborista,1,0,0,1,1
director ejecutivo,0,1,0,1,1
Director of Security,0,0,1,1,1
directora de Privacidad,0,1,0,1,1
DIS,0,0,1,1,1
Discovery Channel,0,0,1,1,1
diseñadora,1,0,0,1,1
diseñadora de moda,1,0,0,1,1
district judge,1,0,0,1,1
District of Delaware,0,0,1,1,1
DKS,0,1,0,1,1
Doctor,0,0,1,1,1
doctor Dr.,0,1,0,1,1
doctora,0,1,0,1,1
Dolley Madison,0,1,0,1,1
Don McGahn,0,0,1,1,1
Dorothy,0,0,1,1,1
dos días,0,0,1,1,1
dos minutos,1,0,0,1,1
Doug Parker,0,1,0,1,1
"Dover, New Hampshire",0,0,1,1,1
Downtown Houston,0,0,1,1,1
Drew Kapp,1,0,0,1,1
Drivers Assistance Program,0,1,0,1,1
Drs.,0,1,0,1,1
Drvengrad,0,1,0,1,1
Duge Bridge,1,0,0,1,1
Duke University School of Medicine,0,0,1,1,1
Dunkirk,0,0,1,1,1
Dutch National Prosecutors' Office,0,0,1,1,1
E.W. Jackson,1,0,0,1,1
Eagles 05:08 Washington,1,0,0,1,1
East African,0,0,1,1,1
East China Sea,0,0,1,1,1
East Germany,0,1,0,1,1
"Eastern Cape, South Africa",1,0,0,1,1
Ed Gillespie,1,0,0,1,1
Edelmira Gutierrez,0,1,0,1,1
Edmund Hillary,0,1,0,1,1
Edward Felix Norton,0,0,1,1,1
Eid al-Fitr,0,0,1,1,1
Eiffel Tower,0,1,0,1,1
eight hours,1,0,0,1,1
eight-meter,0,0,1,1,1
eight-minute,0,0,1,1,1
Einstein,0,1,0,1,1
"Elgin, Texas",0,0,1,1,1
Ellie Sullivan,0,0,1,1,1
email storm,0,1,0,1,1
Emiko Shiokawa,1,0,0,1,1
Emirates,0,1,0,1,1
Energy Committee,1,0,0,1,1
Environment,0,0,1,1,1
Environment Protection Agency,0,0,1,1,1
Eric jr,0,0,1,1,1
Erick Rivas,1,0,0,1,1
Erie,0,1,0,1,1
Erik Weihenmayer,0,0,1,1,1
ERNESTO BENAVIDES,0,1,0,1,1
Ernst,0,1,0,1,1
Escuela de Medicina,0,0,1,1,1
Escuela de Salud Pública,0,1,0,1,1
ESPN,1,0,0,1,1
Estados Unidos Las,0,1,0,1,1
Estocolmo,0,1,0,1,1
Estonia,0,0,1,1,1
Ethan Wu,0,0,1,1,1
Ethnographic Museum,0,1,0,1,1
Eunice Gayson,1,0,0,1,1
Europe 1,1,0,0,1,1
European Capital of Culture,0,1,0,1,1
European Convention of Human Rights,1,0,0,1,1
European lawyer,0,0,1,1,1
European Parliament,1,0,0,1,1
executive education,0,0,1,1,1
Exit Festival,1,0,0,1,1
Fabiola Ferrero,0,0,1,1,1
Fairfax Media,0,1,0,1,1
Fairfield Baptist Church,0,0,1,1,1
Faith Wong,0,0,1,1,1
Fareed Zakaria GPS,0,0,1,1,1
Faru Koe,0,0,1,1,1
Fashion designer,1,0,0,1,1
Fathmath,0,0,1,1,1
Federal Emergency Management Agency,0,1,0,1,1
federal judge,0,0,1,1,1
FEDERICO PARRA,0,0,1,1,1
Fernando,0,0,1,1,1
Ferrari 250 GTO,0,0,1,1,1
Ferraris,0,1,0,1,1
Finance Minister,0,0,1,1,1
finance ministers,0,0,1,1,1
Financial Times,1,0,0,1,1
Finnish Defense Forces,0,0,1,1,1
Fire,0,1,0,1,1
Fire Brigades Union,0,0,1,1,1
Fire TV,0,0,1,1,1
Firefox Focus,1,0,0,1,1
First American,0,0,1,1,1
first day,0,1,0,1,1
first five minutes,0,0,1,1,1
first minutes,0,1,0,1,1
Fiscal Federal para el Distrito de Delaware,1,0,0,1,1
fiscal general,0,0,1,1,1
Fiscalía General de la Nación,0,1,0,1,1
five months,0,0,1,1,1
five-year,0,0,1,1,1
FL,1,0,0,1,1
Fleetwood Mac,1,0,0,1,1
Flickr,0,1,0,1,1
Flood Emergency,0,0,1,1,1
Florida Air Force Reserve Pararescue,0,0,1,1,1
Florida Fish and Wildlife Conservation Commission,0,0,1,1,1
FNB Stadium,0,0,1,1,1
Foot Locker,0,1,0,1,1
Foreign and Commonwealth Office,0,0,1,1,1
foreign policy analyst,0,0,1,1,1
Forest Lawn Memorial Park,0,0,1,1,1
Forrester,0,0,1,1,1
"Fort Wayne, Indiana",0,0,1,1,1
Foundation Vamos Adelante,0,1,0,1,1
four days,0,1,0,1,1
Four hours,1,0,0,1,1
Four Seasons Private Island Maldives,0,1,0,1,1
four weeks,0,1,0,1,1
Francazal,0,0,1,1,1
France Inter,0,0,1,1,1
Francho Baron,0,1,0,1,1
Francoise Nyssen,1,0,0,1,1
Francys Distefano-Arsentiev,0,0,1,1,1
Frank Andrews,0,0,1,1,1
Frankel Leó,0,1,0,1,1
Frederic March,0,0,1,1,1
Freie University,0,0,1,1,1
French Culture Ministry,0,1,0,1,1
French Foreign Ministry,1,0,0,1,1
"Friday, June 8",1,0,0,1,1
"Friday, October 16",0,0,1,1,1
"Friendswood, Texas",0,0,1,1,1
FT's Rochelle,0,1,0,1,1
FTSE 100,1,0,0,1,1
Fuego Eruption Emergency Relief,0,1,0,1,1
fuerzas armadas,0,0,1,1,1
Full Frontal with Samantha Bee,1,0,0,1,1
Full Metal Jacket,1,0,0,1,1
Fundación,0,0,1,1,1
Fundación Vamos Adelante,0,1,0,1,1
G6,1,0,0,1,1
Gabriela,0,1,0,1,1
Gabrielle Jackson,1,0,0,1,1
Garden Route Coast,0,1,0,1,1
"Garland, Texas",1,0,0,1,1
Gartner,1,0,0,1,1
Gary Ross,0,0,1,1,1
Gaza,0,0,1,1,1
GE Aviation,0,1,0,1,1
Gebze,1,0,0,1,1
Gelibolu (Gallipoli),0,0,1,1,1
Gellért Hill,0,1,0,1,1
General,0,0,1,1,1
General John Nicholson,1,0,0,1,1
generals,0,1,0,1,1
George,0,0,1,1,1
George Clooney,0,0,1,1,1
George Howe Colt,1,0,0,1,1
gephyrophobia,1,0,0,1,1
Gerard Marenghi,0,0,1,1,1
gerencia panregional,0,0,1,1,1
gerente,0,0,1,1,1
Gerson Lehrman Group,0,1,0,1,1
Ghostbusters,0,1,0,1,1
Gianluca Mezzofiore,1,0,0,1,1
Giant Panda,0,0,1,1,1
GIC,0,0,1,1,1
Gilder Lehrman Institute of American History,0,1,0,1,1
Gladys,0,0,1,1,1
Glitz*,1,0,0,1,1
Global Director,1,0,0,1,1
Global Jihad Movement,1,0,0,1,1
GLW,0,0,1,1,1
Golden Gate,0,0,1,1,1
Golden State Warriors,1,0,0,1,1
Goodell,0,0,1,1,1
GOOG,0,0,1,1,1
Google Doodle,0,1,0,1,1
Google Home,0,0,1,1,1
Google's main campus,0,0,1,1,1
Gov. Greg Abbott,0,0,1,1,1
Government Accountability Office,1,0,0,1,1
GQ,0,0,1,1,1
Grace Jones,0,1,0,1,1
Grace Sparks,0,1,0,1,1
Gran Bretaña,0,0,1,1,1
Grand Canyon Scenic Area,0,0,1,1,1
grateful to the myriad people,0,1,0,1,1
Great Lakes,1,0,0,1,1
Great Pacific Garbage Patch,0,1,0,1,1
Great Plains,0,1,0,1,1
"Greenbelt, Maryland",0,0,1,1,1
"Greenbelt, Md.",0,0,1,1,1
Greg Berlanti,0,1,0,1,1
Greg Siskind,0,0,1,1,1
Gregory David Roberts,0,1,0,1,1
Grimace,0,1,0,1,1
Group of Seven,0,1,0,1,1
Guatemala Longterm Aid,0,1,0,1,1
Guatemalan Army,0,0,1,1,1
Gulf Cooperation Council,0,0,1,1,1
Gulf of Izmit,0,0,1,1,1
H.R. McMaster,0,1,0,1,1
Hacking,1,0,0,1,1
Hainan,0,1,0,1,1
Haiti,0,0,1,1,1
"Hamilton, Bermuda",0,0,1,1,1
"Hanoi, Vietnam",0,0,1,1,1
Harlem Hospital,1,0,0,1,1
Harris County,1,0,0,1,1
Harris County Sheriff's Department,0,0,1,1,1
Harrison,0,0,1,1,1
Harry Hurt III,1,0,0,1,1
Harvard Business School,1,0,0,1,1
Harvard Medical School,0,0,1,1,1
Haute Route,0,1,0,1,1
Hawaii Civil Defense,1,0,0,1,1
Hawaii County Fire Department,0,1,0,1,1
Hawaii News Now,1,0,0,1,1
Hawaiian Volcano Observatory,0,0,1,1,1
Hayley Sims,0,1,0,1,1
head coach,0,1,0,1,1
Heather Kelly,0,0,1,1,1
Heather Nauert,0,0,1,1,1
Hebei,0,0,1,1,1
Hedwig Kiesler,0,1,0,1,1
Helena Bonham Carter,0,1,0,1,1
Helping Gautemalan Volcano Victims Fund,0,1,0,1,1
her manager,1,0,0,1,1
Hewlett Packard Enterprise,0,1,0,1,1
HGTV,0,1,0,1,1
Hidden Valley,0,0,1,1,1
High Castle,0,0,1,1,1
High School West,0,1,0,1,1
Hill Street Blues,0,1,0,1,1
Hironori Motoki,1,0,0,1,1
his manager,1,0,0,1,1
historian,0,1,0,1,1
Historical Museum of Serbia,0,1,0,1,1
HMO,0,1,0,1,1
Hollie Silverman,0,0,1,1,1
Homeland Security Investigations,1,0,0,1,1
Homero De la Fuente,0,1,0,1,1
Honduras,0,0,1,1,1
Hooghly River,1,0,0,1,1
Hotel La Reunión,0,1,0,1,1
House Committee on Education,0,0,1,1,1
House GOP members,1,0,0,1,1
House Intelligence,1,0,0,1,1
House Intelligence Committee,0,0,1,1,1
House Intelligence Committee Republican,0,1,0,1,1
House Judiciary,0,1,0,1,1
House of Delegates,1,0,0,1,1
House of Lords,0,0,1,1,1
House Select Committee on Benghazi,0,0,1,1,1
Houston Texans,0,0,1,1,1
Howrah Bridge,0,1,0,1,1
https://t.co/9KtJrabPT7,0,0,1,1,1
https://t.co/H7RtMR59Lw,0,0,1,1,1
https://t.co/JUbpbE1Bk0,0,0,1,1,1
https://t.co/K1SRDhndUu,0,1,0,1,1
https://t.co/L0RrsPS5l2,1,0,0,1,1
https://t.co/u9Ta13Alz3,0,0,1,1,1
HTV,1,0,0,1,1
Hua Chunying,1,0,0,1,1
Hubei,1,0,0,1,1
Hugh Hewitt,0,1,0,1,1
Hugo Chávez,1,0,0,1,1
Hulwa Khaleel,0,0,1,1,1
Human Rights Campaign,0,1,0,1,1
Hunan,0,0,1,1,1
Hungarian communist,0,1,0,1,1
Hwang Woo Suk,0,1,0,1,1
Hwasong,0,0,1,1,1
Hyun Kim,0,0,1,1,1
I was glad,1,0,0,1,1
Ian Kawaley,1,0,0,1,1
Iberian peninsula,0,1,0,1,1
IDC,0,0,1,1,1
Idris Elba,1,0,0,1,1
Ilyushin Il,0,0,1,1,1
immigration attorney,0,0,1,1,1
immigration judge,1,0,0,1,1
Independent,0,1,0,1,1
Indiana Jones,1,0,0,1,1
Indict,1,0,0,1,1
Indo-Pacific,1,0,0,1,1
Innocents Abroad,0,0,1,1,1
Inside Westminster Abbey,0,0,1,1,1
Instituto Nacional de Ciencias Forenses,1,0,0,1,1
Intel Committee,1,0,0,1,1
Intelligence committees,0,1,0,1,1
interim president,0,1,0,1,1
International Ladies' Garment Workers Union,0,0,1,1,1
Interstellar,0,1,0,1,1
Investigaciones de Seguridad Nacional,0,1,0,1,1
iPad,0,0,1,1,1
iPhone,0,0,1,1,1
Iran Air,0,0,1,1,1
Iran Aseman Airlines,0,0,1,1,1
Iran nuclear deal,1,0,0,1,1
Iranian banks,1,0,0,1,1
Iraqi,1,0,0,1,1
Irene Rosenfeld,0,1,0,1,1
Isabel de España,0,0,1,1,1
Isla de Chiloé,1,0,0,1,1
Islamic Fashion & Design Council,0,0,1,1,1
Island,0,1,0,1,1
Islington,0,1,0,1,1
Israelis,0,0,1,1,1
Istanbul,0,0,1,1,1
It Takes a Village,0,1,0,1,1
Italy A,0,0,1,1,1
Iván Márquez,0,0,1,1,1
Ivory Coast,1,0,0,1,1
Izmir,0,0,1,1,1
Jack Fischer,0,0,1,1,1
Jack Johnson,0,1,0,1,1
Jack Manning,0,0,1,1,1
Jacky Ghossein,1,0,0,1,1
Jakson Follmann,1,0,0,1,1
Jalisco,0,0,1,1,1
James Griffiths,0,1,0,1,1
James Martin Center for Nonproliferation Studies,0,1,0,1,1
James Mason,0,0,1,1,1
James P. Eakins,0,0,1,1,1
James] Comey,0,1,0,1,1
Jamiel Lynch,1,0,0,1,1
Jan du Plessis,0,1,0,1,1
Jane Rhodes,0,0,1,1,1
Jane Skinner Goodell,0,1,0,1,1
Janet Gaynor,0,0,1,1,1
Japón,0,0,1,1,1
Japan Airlines,0,0,1,1,1
Jared Taylor,1,0,0,1,1
Jarmo Lindberg,0,0,1,1,1
Jason Carroll,0,1,0,1,1
Jason Isbell,0,0,1,1,1
Jason Legnon,0,1,0,1,1
JAVIER LIZON/AFP/Getty Images,0,0,1,1,1
Jay Marine,0,1,0,1,1
Jay Sekulow,0,1,0,1,1
Jeddah,0,1,0,1,1
Jeddah Hilton,0,1,0,1,1
Jeff Spicer,0,0,1,1,1
Jefferson City,1,0,0,1,1
Jenni Marsh,0,1,0,1,1
Jennifer,0,0,1,1,1
Jennifer Henderson,0,0,1,1,1
Jennifer Michael Hecht,1,0,0,1,1
Jennifer Walker,0,0,1,1,1
Jessica Altman,0,0,1,1,1
Jessica Campbell,0,1,0,1,1
Jessica Ravitz,1,0,0,1,1
Jessica Schneider,1,0,0,1,1
Jessie Yeung,0,1,0,1,1
Jet Propulsion Laboratory/Caltech,0,1,0,1,1
Jihad Watch,1,0,0,1,1
Jihadis,1,0,0,1,1
Jill Bialosky,1,0,0,1,1
Jim Cooper,0,0,1,1,1
Jim Whittaker,0,1,0,1,1
Joan Wickersham,1,0,0,1,1
Joanna Gaines,0,1,0,1,1
Joe Arpaio,0,1,0,1,1
John Barrasso,0,0,1,1,1
John Demers,1,0,0,1,1
John Ehrlichman,1,0,0,1,1
John Gore,1,0,0,1,1
John Klein,0,0,1,1,1
John) Kerry,0,1,0,1,1
Johnny Depp,0,1,0,1,1
Johnson Bademosi,0,0,1,1,1
Joint Chiefs,1,0,0,1,1
Jonathan Fitzgerald,0,1,0,1,1
Jonathan Hugh Mance,0,1,0,1,1
JoNel Aleccia,0,0,1,1,1
Joni Ernst,0,0,1,1,1
Jordan Rane,0,1,0,1,1
Jordan Romero braved Everest,0,0,1,1,1
Jordi,1,0,0,1,1
Jorge Arreaza,0,0,1,1,1
José Miguel Vivanco,0,0,1,1,1
Josep Borrell,0,1,0,1,1
Joseph Curtatone,0,0,1,1,1
Joseph Stalin,0,0,1,1,1
Josh Axelrod,0,0,1,1,1
Josh Campbell,0,1,0,1,1
Josh Ferrell,0,0,1,1,1
Josh Newman,0,0,1,1,1
Josue Lara,1,0,0,1,1
JPL engineer,0,1,0,1,1
JPMorgan,0,0,1,1,1
JUAN BARRETO,0,0,1,1,1
Juana Summers,1,0,0,1,1
Julia Carpenter,0,0,1,1,1
Julia Horowitz,0,0,1,1,1
Julia Jassey,0,0,1,1,1
Julie Martinez,0,1,0,1,1
"June 7th, 2018",0,0,1,1,1
junio de 1969,0,0,1,1,1
junio de 2011,0,0,1,1,1
junio de 2017,0,0,1,1,1
Just In,1,0,0,1,1
Justice and Labor,1,0,0,1,1
Károly,0,0,1,1,1
Kaiser Health News,0,0,1,1,1
Kaiser Permanente,0,1,0,1,1
Kalemegdan Park,0,1,0,1,1
Kami Rita Sherpa,1,0,0,1,1
Karakoram Highway,1,0,0,1,1
Karen McDougal,0,1,0,1,1
Karl Marx,0,0,1,1,1
Kasie Hunt,1,0,0,1,1
Kate Brosnahan Spade,1,0,0,1,1
Kate Moss,0,0,1,1,1
Kathleen Mills,1,0,0,1,1
Katrina,1,0,0,1,1
Katy Wong,0,1,0,1,1
Kaya Yurieff,1,0,0,1,1
Kaylee Hartung,0,0,1,1,1
Keema,1,0,0,1,1
Kelenföld train station,0,0,1,1,1
Kelsi Daniell,0,0,1,1,1
Kendall Trammell,0,0,1,1,1
Kenneth Leveno,0,1,0,1,1
Kerala,0,0,1,1,1
Key Allegro,1,0,0,1,1
Keystone State,0,1,0,1,1
KGMB,1,0,0,1,1
KHNL,1,0,0,1,1
Kill Bill,0,0,1,1,1
Kim,0,0,1,1,1
Kim Conley,0,0,1,1,1
Kingwood Township,1,0,0,1,1
Kiranjeet Kaur,0,1,0,1,1
Knight,0,0,1,1,1
Kobe,0,1,0,1,1
"Kobe, Japan",1,0,0,1,1
Kodak,0,0,1,1,1
Korean peninsula,1,0,0,1,1
Kris Kristofferson,0,0,1,1,1
Kristian Saucier,0,0,1,1,1
Kuda Huraa,0,1,0,1,1
Kyle Almond,1,0,0,1,1
Kyrie Irving,0,0,1,1,1
La carta robada,0,0,1,1,1
La Casa Blanca,0,0,1,1,1
La Chacra,0,1,0,1,1
LA County Medical Examiner's Office,0,0,1,1,1
"La Grange, Texas",0,0,1,1,1
La République En Marche,0,1,0,1,1
La Vega,0,0,1,1,1
Líbano,0,1,0,1,1
Labrador,0,0,1,1,1
Lago Verde de Hawai,0,1,0,1,1
Lagos,1,0,0,1,1
Lampedusa,1,0,0,1,1
Lancet,0,0,1,1,1
Landaa Giraavaru,0,1,0,1,1
Lao,0,0,1,1,1
Lapseki,0,0,1,1,1
Lars Eller,0,1,0,1,1
last August,0,1,0,1,1
Laura Dolan,0,0,1,1,1
Lauren Fox,1,0,0,1,1
Lauren Said-Moorhouse,0,0,1,1,1
Laurie Ure,0,0,1,1,1
lawyer,1,0,0,1,1
laze,0,0,1,1,1
LCD,0,0,1,1,1
Leaf Clover Collection,0,0,1,1,1
LeBron James,1,0,0,1,1
LeBron teammate,0,1,0,1,1
legislative director,0,1,0,1,1
Legislature,0,0,1,1,1
Legos,0,0,1,1,1
Les Allamby,0,0,1,1,1
Letonia,0,0,1,1,1
Lewinksy,0,0,1,1,1
"Lewis ""Scooter"" Libby",0,1,0,1,1
Lhakpa Sherpa,1,0,0,1,1
Libyan Coast Guard,0,0,1,1,1
lieutenant colonel,0,0,1,1,1
Life is a Miracle,0,0,1,1,1
Life Legal Defense Foundation,0,0,1,1,1
Life on Mars?,0,1,0,1,1
"Lilburn, Georgia",0,0,1,1,1
Lima,0,1,0,1,1
Lindsay,0,1,0,1,1
Lineage 1000E,0,1,0,1,1
Ling Ling Chang,0,0,1,1,1
Linger,0,1,0,1,1
Lisa Blunt,1,0,0,1,1
Little Oscar,1,0,0,1,1
Little Rock,0,1,0,1,1
Lituania,0,0,1,1,1
Livia Borghese,0,0,1,1,1
Living History,0,0,1,1,1
Lloyd Blankfein,0,1,0,1,1
Loews Regency,0,1,0,1,1
Lois Lane,1,0,0,1,1
Lollipop Guild Member,0,1,0,1,1
Lollypop Guild,1,0,0,1,1
London Stock Exchange,0,0,1,1,1
London's stock market,1,0,0,1,1
Long Beach Island,1,0,0,1,1
"Long Beach, California",1,0,0,1,1
Louis Kuijs,0,1,0,1,1
Louise Jandura,0,1,0,1,1
Louisiana Department of Wildlife and Fisheries,0,0,1,1,1
Louisiana National Guard,0,0,1,1,1
"Louisville, Kentucky",0,1,0,1,1
Lowell Thomas Award,0,0,1,1,1
Lower Peninsulas,0,1,0,1,1
Lowy Institute,0,0,1,1,1
Lt. Cmdr.,0,1,0,1,1
Lt. Col.,1,0,0,1,1
Lucas Wu,0,0,1,1,1
Luciano Marín Arango,0,1,0,1,1
Lucile Turut,0,1,0,1,1
Luis Omar Ocasio-Capo,1,0,0,1,1
Luisiana,0,1,0,1,1
Lukas Nelson,0,1,0,1,1
Lululemon,0,0,1,1,1
Lydia DePillis,1,0,0,1,1
Lynn Margulis,0,0,1,1,1
Lynne Sladky,0,0,1,1,1
Lyon,0,0,1,1,1
Ma,0,0,1,1,1
MÁS,0,0,1,1,1
Mackinac Bridge,1,0,0,1,1
Mackinac Bridge Authority,1,0,0,1,1
Madame Tussauds Hollywood,0,1,0,1,1
Madison Park,1,0,0,1,1
Maegan Vazquez,0,0,1,1,1
Maharashtra,0,0,1,1,1
Main Street,0,0,1,1,1
Mainz,0,0,1,1,1
Malavath Poorna,0,0,1,1,1
Maldivian,1,0,0,1,1
Malta,1,0,0,1,1
Maltese,0,0,1,1,1
Managing Director,0,1,0,1,1
managing partner,1,0,0,1,1
"Manchester, New Hampshire",1,0,0,1,1
Manhattan Project,1,0,0,1,1
Manta Watch,0,0,1,1,1
Manuel Zelaya,0,0,1,1,1
Mao Zedong,0,0,1,1,1
Maplin,1,0,0,1,1
Marc Mezvinsky,0,1,0,1,1
Marc Rod,0,1,0,1,1
Marc Short,0,1,0,1,1
Marcel Massini,0,1,0,1,1
Marcela Aparicio,0,0,1,1,1
Marcelo Ballvé,0,1,0,1,1
Marco Antonio Rocha,1,0,0,1,1
MARDI,0,0,1,1,1
Mareen,0,0,1,1,1
Maria,0,1,0,1,1
Marian Bull,0,1,0,1,1
Marian Goodell,1,0,0,1,1
Marine Centre,0,1,0,1,1
Marine Le Pen,0,1,0,1,1
Marion VA Medical Center,0,0,1,1,1
"Marion, Illinois",0,1,0,1,1
Marissa Mayer,1,0,0,1,1
Mark,0,0,1,1,1
Mark Backé,1,0,0,1,1
Mark Meadows,1,0,0,1,1
Mark Ronson,0,0,1,1,1
Mark Rutte,0,1,0,1,1
Mark Sweney,0,0,1,1,1
Marks & Spencer,1,0,0,1,1
Marruecos,1,0,0,1,1
Mars Descent Imager,0,0,1,1,1
Marsella,0,0,1,1,1
Martin Garrix,0,1,0,1,1
Martin Seaward,0,1,0,1,1
Mary Ilyushina,1,0,0,1,1
Mary Wareham,0,1,0,1,1
marzo,0,0,1,1,1
Mast,0,0,1,1,1
Matt McFarland,1,0,0,1,1
Matt Valliere,0,1,0,1,1
Matterhorn,1,0,0,1,1
Matthew Koser,1,0,0,1,1
Mayor McCheese,0,1,0,1,1
McCain,1,0,0,1,1
McConnell Center,0,0,1,1,1
McDonald's Hamburglar,0,1,0,1,1
Mediterranean Sea,1,0,0,1,1
Meg Whitman,1,0,0,1,1
Megan Thomas,0,0,1,1,1
Meghan Markle,0,1,0,1,1
Mejicanos,0,0,1,1,1
Melani Zurawski,1,0,0,1,1
Memoirs of a Geisha,1,0,0,1,1
Memphis,0,0,1,1,1
Mercedes Benzes,0,0,1,1,1
Mercedes Schlapp,0,1,0,1,1
Mercer University School of Medicine,0,0,1,1,1
Met,1,0,0,1,1
Met Gala,0,1,0,1,1
Metro Line 4,0,0,1,1,1
mexicano,1,0,0,1,1
Mexicanos,0,0,1,1,1
MFA Connection,0,0,1,1,1
MGI,1,0,0,1,1
Michael D'Antonio,0,1,0,1,1
Michael Hancock,0,0,1,1,1
Michael Jordan,1,0,0,1,1
Micheal Jackson,0,0,1,1,1
Michelin-starred,0,1,0,1,1
Micron,0,0,1,1,1
Middle District of Florida,0,0,1,1,1
Middle Eastern,0,1,0,1,1
Mighty Mac,0,0,1,1,1
Migos,1,0,0,1,1
Miguel,0,1,0,1,1
Mike,0,1,0,1,1
Mike Bishop,0,0,1,1,1
Mike Conaway,0,0,1,1,1
Mike Galanos,0,0,1,1,1
miles de kilómetros,0,0,1,1,1
military chiefs,0,1,0,1,1
Mindy Kaling,0,0,1,1,1
Mini-Me,1,0,0,1,1
Minister of Home Affairs,0,1,0,1,1
Ministerio de Ambiente,0,0,1,1,1
ministra de Asuntos Exteriores,0,0,1,1,1
ministro de Asuntos Exteriores,0,1,0,1,1
ministro de Obras Públicas,1,0,0,1,1
ministros,0,1,0,1,1
Ministry of Foreign Affairs,0,0,1,1,1
Minyuan Zhao,0,1,0,1,1
MLB,0,0,1,1,1
Mohammed Abdiker,1,0,0,1,1
Mokra Gora,0,1,0,1,1
Molly Ball,0,1,0,1,1
"Mon June 11, 2018",0,0,1,1,1
Monday or Tuesday,0,0,1,1,1
"Monday, August 28",0,0,1,1,1
"Monday, June 11, 2018",0,0,1,1,1
Mondelez,0,1,0,1,1
MoneyGram,1,0,0,1,1
Moni Mulepati,0,0,1,1,1
Monica Lam,0,0,1,1,1
Montafon,1,0,0,1,1
Montes de María,0,0,1,1,1
Monument of Culture of Exceptional Importance,1,0,0,1,1
"Moon Bay, Calif.",1,0,0,1,1
"Mountain View, California",0,0,1,1,1
Mr. Magoo,0,0,1,1,1
MuchMusic,0,0,1,1,1
Muhammed,1,0,0,1,1
Mumbai,0,0,1,1,1
Munchkin,0,1,0,1,1
Munchkinland,0,0,1,1,1
Museum of Beekeeping,0,0,1,1,1
Muslim Brotherhood,0,0,1,1,1
MVP Health Care,1,0,0,1,1
Nadine Schmidt,0,0,1,1,1
Naima Moutchou,0,1,0,1,1
"Narita, Chiba, Japan",0,0,1,1,1
NAS,0,0,1,1,1
"Nashua, New Hampshire",0,0,1,1,1
Nasra Yahya,1,0,0,1,1
Nate Cohn,0,0,1,1,1
National Academy of Sciences,0,0,1,1,1
National Coordinator for Disaster Reduction,0,0,1,1,1
National Election,1,0,0,1,1
National Geographic magazine,0,1,0,1,1
National Guard,0,0,1,1,1
national security adviser,0,1,0,1,1
National Security Council Spencer,1,0,0,1,1
National Suicide Hotline,1,0,0,1,1
National Violent Death Reporting System,1,0,0,1,1
National Vital Statistics System,0,1,0,1,1
NDAA,1,0,0,1,1
Neal Katyal,0,0,1,1,1
Nepal,0,0,1,1,1
Nepali,1,0,0,1,1
Nery Otoniel Gomez Rivas,0,0,1,1,1
Neville,0,1,0,1,1
New Frontier Data,0,0,1,1,1
New York state legislature,1,0,0,1,1
New York Stock,0,0,1,1,1
next Tuesday,0,1,0,1,1
NFL Commissioner,0,0,1,1,1
NGO,0,0,1,1,1
Nick Freitas,1,0,0,1,1
Nick Paton Walsh,0,0,1,1,1
Nicole Chavez,0,0,1,1,1
Nigella Lawson,0,1,0,1,1
Nikola Tesla Museum,1,0,0,1,1
Nine,0,0,1,1,1
nine years,1,0,0,1,1
Nissan,1,0,0,1,1
Nixon adviser,1,0,0,1,1
Noah Gray,1,0,0,1,1
Noel Fritsch,0,0,1,1,1
Noether,0,0,1,1,1
North Asia,0,0,1,1,1
North Hollywood,0,0,1,1,1
Northern Ireland Assembly,0,0,1,1,1
Northern Pakistan,1,0,0,1,1
NSA,0,1,0,1,1
Nueva Jersey,0,1,0,1,1
Nueva Orleans,0,1,0,1,1
NXP Semiconductors,0,0,1,1,1
NYPD Blue,1,0,0,1,1
NYT,1,0,0,1,1
O.T. Genasis,0,1,0,1,1
بينيدكت السادس عشر,0,1,0,1,1
دار عرض,0,1,0,1,1
ديرك دالاس,0,0,1,1,1
شرى,1,0,0,1,1
شوقي السيد,0,0,1,1,1
شهرين,1,0,0,1,1
آدم,0,1,0,1,1
آذار,1,0,0,1,1
أبوظبي,0,1,0,1,1
أسامة بن لادن,0,1,0,1,1
ألمانيا,1,0,0,1,1
أيار,0,1,0,1,1
أيار 2016,1,0,0,1,1
إبراهيم محلب,0,0,1,1,1
رئيس للوزراء,0,1,0,1,1
رئيسا,1,0,0,1,1
روبرت مولر,0,1,0,1,1
روبونجي,0,1,0,1,1
روسيا,1,0,0,1,1
ريوجي ليدوكورو,0,1,0,1,1
ثلاثين دقيقة,0,1,0,1,1
البابا,0,1,0,1,1
البحر الأحمر,0,1,0,1,1
البيت الأبيض,0,1,0,1,1
الشرق الأوسط,0,1,0,1,1
الشيعي,0,1,0,1,1
الأرجنتين,0,1,0,1,1
الأحد,1,0,0,1,1
الإمارات,0,1,0,1,1
الاردن,0,0,1,1,1
الجمهوري,0,1,0,1,1
الخليجي,1,0,0,1,1
الصليب الأحمر الدولية,1,0,0,1,1
العالم,0,0,1,1,1
العامين,1,0,0,1,1
الزعيم,1,0,0,1,1
السعودي,1,0,0,1,1
الحسين بن عبد الله الثاني,1,0,0,1,1
القائد العام,0,0,1,1,1
القطري,1,0,0,1,1
الله,0,0,1,1,1
الـ52 عاماً,0,1,0,1,1
المصري اليمين الدستورية,1,0,0,1,1
الممثل,1,0,0,1,1
اليومين,0,1,0,1,1
اليمنيين,0,1,0,1,1
جدّة,0,1,0,1,1
جامعة القاهرة,1,0,0,1,1
جامعة هارفارد,0,1,0,1,1
طوكيو,0,1,0,1,1
عبد الرحيم,0,0,1,1,1
عربي,0,1,0,1,1
عز الدين شكري,0,1,0,1,1
عمان,0,1,0,1,1
زيان زوانة,1,0,0,1,1
سوريا,0,0,1,1,1
سمير العبد,0,0,1,1,1
سكاي فول,1,0,0,1,1
توم ميرشانت,0,1,0,1,1
تيم براونيغ,0,1,0,1,1
obispos,0,0,1,1,1
Ocean's 11,1,0,0,1,1
Ocean's Eleven,0,0,1,1,1
Ode to Joy,0,0,1,1,1
Office of the Chief Medical Examiner,0,1,0,1,1
Office of the Director of National Intelligence,0,0,1,1,1
Oficina del Médico Forense,1,0,0,1,1
Ojay Liburd,1,0,0,1,1
Ojuela Bridge,1,0,0,1,1
Oklahoma City Thunder,0,1,0,1,1
Olivia Milch,0,0,1,1,1
Olivier Knox,1,0,0,1,1
one afternoon,0,0,1,1,1
one hour,0,1,0,1,1
One week,0,0,1,1,1
one-hour,0,0,1,1,1
One-month,0,0,1,1,1
حزب الغد,0,1,0,1,1
"Orange, Texas",0,0,1,1,1
Orchard Lakes,0,0,1,1,1
Oreo,0,0,1,1,1
Oreo Cookies,0,1,0,1,1
Orkney Islands,0,0,1,1,1
Osama Bin Laden,0,0,1,1,1
Osman Gazi,0,0,1,1,1
Ottavia,0,0,1,1,1
Otter Trail,0,1,0,1,1
Ottoman,0,1,0,1,1
حيدر العبادي,0,0,1,1,1
OUTBermuda,0,0,1,1,1
Oxford Economics,0,0,1,1,1
Ozman Gazi,0,1,0,1,1
Pablo Castillo,0,0,1,1,1
Paisley,0,1,0,1,1
Pakistani Chief of Army,0,0,1,1,1
Palestinian Health Ministry,1,0,0,1,1
Palestinian uprising against Israel,1,0,0,1,1
Pamela Brown,0,0,1,1,1
Pampers,0,1,0,1,1
Panda Gigante,0,0,1,1,1
Papa,0,0,1,1,1
París,0,0,1,1,1
Parija Kavilanz,1,0,0,1,1
Paris Air Show,0,1,0,1,1
Park Ave,0,0,1,1,1
Parlamento,1,0,0,1,1
Patients Rights Action Fund,0,0,1,1,1
Patrick Oppmann,0,0,1,1,1
Paul George,0,0,1,1,1
Paul Jacobson,0,0,1,1,1
Paul Nehlan,0,1,0,1,1
Paul P. Murphy,1,0,0,1,1
Paul Scharre,0,0,1,1,1
PC,0,0,1,1,1
Peace Corps,0,1,0,1,1
"Pearland, Texas",0,0,1,1,1
Pedro Domingos,0,0,1,1,1
Pemba Dorje,0,0,1,1,1
Pennsylvania Insurance Commissioner,1,0,0,1,1
People for Alternatives,0,1,0,1,1
Permanent Subcommittee on Investigation,0,0,1,1,1
Permanent Subcommittee on Investigations,0,0,1,1,1
personal attorney,0,1,0,1,1
Pest,0,0,1,1,1
PET,0,1,0,1,1
Petitioner,0,0,1,1,1
PG-13,0,0,1,1,1
PGA,1,0,0,1,1
Phil Gast,0,0,1,1,1
Phil McCarten,0,0,1,1,1
"Philippines, Democratic Republic of Congo",0,0,1,1,1
Physiology,1,0,0,1,1
pic.twitter.com/41llVxwDEq,0,1,0,1,1
pic.twitter.com/C7dq8hHSjr,0,0,1,1,1
pic.twitter.com/dxLt2xnoFd,0,0,1,1,1
pic.twitter.com/E3VxT1lOhz,0,0,1,1,1
pic.twitter.com/GdLOLcVBmr,0,0,1,1,1
pic.twitter.com/qC5vDDxW9W,1,0,0,1,1
pic.twitter.com/typwaFkOBT,0,0,1,1,1
pic.twitter.com/ur0bfCgoBJ,0,0,1,1,1
pic.twitter.com/uu1ieJVk70,0,0,1,1,1
pic.twitter.com/xtJHGGtdwo,0,1,0,1,1
Pioneer Group,0,0,1,1,1
Piper,0,1,0,1,1
Platts Energy,0,0,1,1,1
Playboy,0,1,0,1,1
Poet Laureate,0,1,0,1,1
police chiefs,1,0,0,1,1
police officer,0,0,1,1,1
policy director,1,0,0,1,1
Politico,1,0,0,1,1
Pope Benedict XVI,0,0,1,1,1
Port of Los Angeles,0,0,1,1,1
PowerPoint,0,0,1,1,1
PPO,0,0,1,1,1
Prada,1,0,0,1,1
president of avionics,0,1,0,1,1
president of basketball operations,1,0,0,1,1
President's Council on Bioethics,0,0,1,1,1
President's personal attorney,0,1,0,1,1
President's rule,0,0,1,1,1
press secretary berates staff,0,1,0,1,1
primer mes,0,0,1,1,1
primer ministro de Canadá,0,0,1,1,1
primeros días,0,0,1,1,1
Prince,0,0,1,1,1
Prince Harry,1,0,0,1,1
Prince William County,1,0,0,1,1
Principal,1,0,0,1,1
principal deputy director,0,0,1,1,1
program director,1,0,0,1,1
program manager,0,0,1,1,1
Prosecutor,1,0,0,1,1
"Provincetown, Massachusetts",0,0,1,1,1
Pruitt,1,0,0,1,1
PSOE,0,1,0,1,1
Public Policy Forum,0,0,1,1,1
Qamar Bajwa,0,0,1,1,1
Queen Mary University,0,0,1,1,1
Quema de Washington,0,0,1,1,1
Quigley,0,0,1,1,1
Quinnipiac,0,0,1,1,1
Quiroga,0,1,0,1,1
QWERTY,0,1,0,1,1
Rabindra Setu,0,1,0,1,1
Rabindranath Tagore,0,1,0,1,1
Radina Gigova,0,0,1,1,1
Rakhine,0,0,1,1,1
Ralph Northam,1,0,0,1,1
Rand,1,0,0,1,1
RAND Corp.,0,1,0,1,1
"Randa, Switzerland",0,1,0,1,1
rat pack,0,0,1,1,1
Reasons Why,1,0,0,1,1
Rebecca Berg,0,0,1,1,1
Recreation Vehicle Industry Association,0,1,0,1,1
Red de Estudios,0,0,1,1,1
Reducción de Desastres,0,0,1,1,1
Reef,0,0,1,1,1
Reglamento Sanitario de los Alimentos,0,0,1,1,1
Reglamento Sanitario de los Alimentos De,0,0,1,1,1
Reinhold Messner,0,0,1,1,1
Rep. Jim McGovern,1,0,0,1,1
Republic of Upper Volta,0,0,1,1,1
research director,0,1,0,1,1
Reserva Natural de Wolong,0,1,0,1,1
Reserva Natural Wolong,0,1,0,1,1
Resolute Support,0,1,0,1,1
Resolution Imaging Science Experiment,0,0,1,1,1
Restaurant manager,1,0,0,1,1
Revenge of the Nerds,0,0,1,1,1
rey,0,0,1,1,1
reyes,0,1,0,1,1
reyes de España,0,1,0,1,1
Rial,0,1,0,1,1
Rich Greenfield,0,0,1,1,1
Richard Wagner,0,0,1,1,1
"Richardson, Texas",0,0,1,1,1
"Richmond, Texas",0,0,1,1,1
Rich's,0,1,0,1,1
Rick Scott,0,0,1,1,1
Rina Singh,0,0,1,1,1
RIO,1,0,0,1,1
Rio Tinto,1,0,0,1,1
Ritz-Carlton,0,0,1,1,1
Riverside County Superior Court,0,1,0,1,1
Rob McLean,0,0,1,1,1
Robert McCance,0,0,1,1,1
Rochester,1,0,0,1,1
Roger Goodell,0,0,1,1,1
Roku,0,1,0,1,1
Roman,0,1,0,1,1
Roosevelt Room,1,0,0,1,1
Rosângela Loureiro,1,0,0,1,1
Rose Garden,0,0,1,1,1
Roseanne,0,1,0,1,1
"Rosenberg, Texas",0,0,1,1,1
Ross School of Business,1,0,0,1,1
Royal Gazette,0,1,0,1,1
Royal Gorge Bridge,0,1,0,1,1
Royal Rush Skycoaster,0,0,1,1,1
RPP,1,0,0,1,1
RT,0,1,0,1,1
Rubi,0,1,0,1,1
Rudolph Giuliani,1,0,0,1,1
Ruger SR40,0,0,1,1,1
Ruth Benerito,0,0,1,1,1
Ryan Browne,0,0,1,1,1
Ryan Struyk,0,1,0,1,1
Saba Hamedy,0,1,0,1,1
"Sabratha, Libya",0,0,1,1,1
Sacred Heart Catholic Church,0,0,1,1,1
Sadler,1,0,0,1,1
Salvadorans,1,0,0,1,1
Sam Bradpiece,0,0,1,1,1
Sam Elliott,0,0,1,1,1
Sam Speights,1,0,0,1,1
Samm Sacks,0,0,1,1,1
Samsung Smart TV,0,0,1,1,1
San Antonio (Texas),0,1,0,1,1
San Diego,0,1,0,1,1
San Francisco 49er,1,0,0,1,1
San Joaquin Valley,0,0,1,1,1
San Sebastián,0,0,1,1,1
Sanders,1,0,0,1,1
Santa Barbara,0,1,0,1,1
Santa Cruz,1,0,0,1,1
Sara Golden,0,1,0,1,1
Sarah Hallam,0,0,1,1,1
Sarah Manguso,1,0,0,1,1
Sarai,0,1,0,1,1
Sasha,0,0,1,1,1
Saturday Night Live,1,0,0,1,1
"Saturday, August 26",1,0,0,1,1
"Saturday, November 1",1,0,0,1,1
Saudi Arabian,0,1,0,1,1
Schiff,1,0,0,1,1
Scholes International Airport,0,0,1,1,1
School,1,0,0,1,1
School nutritionist,0,0,1,1,1
señora,0,0,1,1,1
Sebastian Shukla,0,0,1,1,1
SEC,1,0,0,1,1
Secretaría de Gobernación,1,0,0,1,1
Secretaría de Marina,1,0,0,1,1
Secretaría de Marina de México,0,0,1,1,1
secretario de Desarrollo Internacional,0,1,0,1,1
security analyst,0,0,1,1,1
security director,0,1,0,1,1
SEM,0,0,1,1,1
Senate Banking Committee,0,1,0,1,1
Senate Environment and Natural Resources Committee,0,0,1,1,1
Senate Foreign Relations,0,1,0,1,1
Senate Judiciary Committee,1,0,0,1,1
Senate's Energy Committee,1,0,0,1,1
senator and secretary of state,0,1,0,1,1
Senators,1,0,0,1,1
senior adviser,0,1,0,1,1
senior defense analyst,1,0,0,1,1
senior director,0,0,1,1,1
senior vice president,1,0,0,1,1
Sentosa Island,0,1,0,1,1
septiembre de 2017,0,0,1,1,1
Sera Prognostics,0,1,0,1,1
Serbian,0,1,0,1,1
serendipity,1,0,0,1,1
Sergei Arsentiev,1,0,0,1,1
Serranía del Perijá,0,0,1,1,1
Servicio de Inmigración y Aduanas,0,0,1,1,1
Servicio Nacional de Prevención del Suicidio,0,1,0,1,1
Sessions 08:18 Washington,0,0,1,1,1
Seusis Hernández,0,0,1,1,1
seventy years,0,1,0,1,1
Shane Johnson,0,0,1,1,1
Shanghai,0,0,1,1,1
Shangri-La,1,0,0,1,1
Shantaram,0,0,1,1,1
Shayan Basu,0,0,1,1,1
Sheena Jones,0,0,1,1,1
Sheena McKenzie,0,1,0,1,1
Shenzhen,0,0,1,1,1
Sheri McCoy,0,0,1,1,1
Sheriff entered,0,1,0,1,1
Sherpa Tensing,0,1,0,1,1
Sherri Lydon,1,0,0,1,1
Shijiazhuang,1,0,0,1,1
Shirley Ann Jones,1,0,0,1,1
showrunner,0,1,0,1,1
Siemens,0,0,1,1,1
Sienna Miller,0,1,0,1,1
Sierra Nevada de Santa Marta,0,0,1,1,1
siete kilómetros,1,0,0,1,1
Simona Mangiante,0,0,1,1,1
Sin reservas,0,1,0,1,1
Sirat,0,1,0,1,1
SiriusXM,1,0,0,1,1
Siskind,0,0,1,1,1
Sistema Nacional de Registro de Muertes Violentas,0,0,1,1,1
Skadarlija,0,1,0,1,1
Sky,1,0,0,1,1
Sky Sports,1,0,0,1,1
slam dunk,0,0,1,1,1
Smithsonian NMAAHC,0,0,1,1,1
Snake River,0,0,1,1,1
SNAP,1,0,0,1,1
Snap Inc.,1,0,0,1,1
Society of American Travel Writers,1,0,0,1,1
Solomon Radner,0,0,1,1,1
Somervile,0,0,1,1,1
Sonny Jackson,1,0,0,1,1
Sony Pictures,1,0,0,1,1
Sophie Rebmann,0,0,1,1,1
South African,0,0,1,1,1
South America,0,1,0,1,1
South Beach,0,0,1,1,1
South Dakota,1,0,0,1,1
Southeast Asia,1,0,0,1,1
Southern District,0,0,1,1,1
Southern District of New York,1,0,0,1,1
Soviet,0,0,1,1,1
Space GO,0,0,1,1,1
SpaceX COO Gwynne Shotwell,0,1,0,1,1
Spangled Banner,0,0,1,1,1
Spate,0,0,1,1,1
Special Counsel,0,0,1,1,1
Spencer Feingold,0,1,0,1,1
Splash,0,0,1,1,1
Spotify,0,0,1,1,1
Sreoshi Mukherjee,1,0,0,1,1
SSM Health,0,0,1,1,1
St. Martin's Press,0,1,0,1,1
St. Petersburg,0,0,1,1,1
staff secretary,1,0,0,1,1
Staffing Industry Analysts,0,1,0,1,1
Stanley Cohen,1,0,0,1,1
Staph,1,0,0,1,1
State Department spokeswoman,1,0,0,1,1
State Dining Room,0,1,0,1,1
Stefano Pozzebon,0,0,1,1,1
Stem Cell Research,0,0,1,1,1
Steph Curry,1,0,0,1,1
Stephan Plannck,0,0,1,1,1
Stephane Kasriel,1,0,0,1,1
Stephen Dillane,0,1,0,1,1
Stephen Hawking,1,0,0,1,1
Stephen Larson,0,0,1,1,1
Stephen Quake,0,1,0,1,1
Stephen Walsh,0,0,1,1,1
Steve Culver,0,0,1,1,1
Steve Jobs,0,1,0,1,1
Steven Bloom,0,0,1,1,1
Steven Bochco,1,0,0,1,1
Still America,0,1,0,1,1
Storms River,0,0,1,1,1
Storms River Suspension Bridge,1,0,0,1,1
StrategicAero Research,1,0,0,1,1
Sub-Saharan countries,1,0,0,1,1
Sudan,0,1,0,1,1
Suhada al Nasr,0,1,0,1,1
"Sun October 30, 2016",1,0,0,1,1
Sundar Pichai,0,0,1,1,1
"Sunday, August 27",0,0,1,1,1
"Sunday, June 3",0,1,0,1,1
Sunlen Serfaty,0,0,1,1,1
Super Bug,1,0,0,1,1
Super PAC,1,0,0,1,1
Surviving My Mother,1,0,0,1,1
Susanna Feldman,0,0,1,1,1
Susser,0,0,1,1,1
Swati Singh Sambyal,0,0,1,1,1
Swede,1,0,0,1,1
"Sydney, Australia",0,0,1,1,1
Sylvester Stallone,0,0,1,1,1
"Taft, Texas",1,0,0,1,1
Talib Visram,1,0,0,1,1
Tamae Watanabe,0,0,1,1,1
Tamara Qiblawi,0,0,1,1,1
Tammy Dominguez,0,0,1,1,1
Tanzania,1,0,0,1,1
Taormina,1,0,0,1,1
"Tarzana, California",1,0,0,1,1
TBS,0,0,1,1,1
TCM,0,0,1,1,1
Technology Policy Program,0,0,1,1,1
Ted Cruz,1,0,0,1,1
Ted Howze,1,0,0,1,1
Temasek,0,0,1,1,1
Tenzing Norgay,0,1,0,1,1
Teruel,1,0,0,1,1
Tesla,0,0,1,1,1
Texas Air National Guard,0,0,1,1,1
Texas Flood,0,0,1,1,1
The Art of the Deal,1,0,0,1,1
The Bonfire of the Vanities,0,1,0,1,1
The Chemical Composition of Foods,0,1,0,1,1
The Commission,0,0,1,1,1
The Daily Beast,0,0,1,1,1
The Dick Van Dyke Show,0,1,0,1,1
The Goldbergs,0,0,1,1,1
The Guardian,1,0,0,1,1
the past,0,0,1,1,1
The Right Stuff,1,0,0,1,1
The Ringer,1,0,0,1,1
The Situation Room,0,0,1,1,1
The Taste,0,0,1,1,1
The Tonight,0,1,0,1,1
The Twilight Zone,0,0,1,1,1
the Union,0,1,0,1,1
The United States of America,0,0,1,1,1
Theodore Dobias,0,1,0,1,1
this April,1,0,0,1,1
this November,0,0,1,1,1
This Saturday,0,0,1,1,1
THO,0,0,1,1,1
Thor Industries,0,0,1,1,1
THR,0,0,1,1,1
Three days,1,0,0,1,1
three-month,1,0,0,1,1
Thumbtack,0,1,0,1,1
"Thursday, May 24",1,0,0,1,1
Tidwell Road,0,0,1,1,1
Tim Bergling,0,0,1,1,1
Tim Kaine,0,0,1,1,1
Tim Lister,0,0,1,1,1
Tim Malloy,0,1,0,1,1
Time,0,1,0,1,1
Time magazine,0,1,0,1,1
Tinseltown,0,0,1,1,1
Tipper,0,0,1,1,1
TLC,1,0,0,1,1
TNT GO,0,1,0,1,1
Tooncast,0,1,0,1,1
Torbjörn Lööf,0,1,0,1,1
Toys 'R' Us,1,0,0,1,1
Trabbies,0,1,0,1,1
Transportation Secretary,0,0,1,1,1
TrendForce,0,0,1,1,1
Triple Crown,0,0,1,1,1
Triple Crown of horse,0,1,0,1,1
Trooper,0,0,1,1,1
Troy Nehls,0,0,1,1,1
Trump campaign manager,1,0,0,1,1
Trump Hotel,0,0,1,1,1
Tsitsikamma National Park,0,1,0,1,1
"Tuesday, August 29",0,0,1,1,1
tuiteó,0,1,0,1,1
Tupolev,1,0,0,1,1
Tuxpan,0,0,1,1,1
TV abierta,0,0,1,1,1
twitter,0,0,1,1,1
Twitter diplomacy,0,0,1,1,1
Two months,0,0,1,1,1
two-day,0,1,0,1,1
two-feet,0,0,1,1,1
TWTR,0,0,1,1,1
Ty Cobb,0,0,1,1,1
U.S. Chamber of Commerce,0,0,1,1,1
U.S. Embassy in Tehran,0,0,1,1,1
U.S. Naval Reserve,1,0,0,1,1
U.S. Virgin Islands,0,0,1,1,1
وزارة الداخلية,0,1,0,1,1
وزارة الاسكان,0,1,0,1,1
وزير الدولة,0,0,1,1,1
وزير الإسكان المهندس,0,1,0,1,1
ولي العهد,1,0,0,1,1
وليد الحسيني,0,1,0,1,1
وكالة الأنباء العراقيج,0,0,1,1,1
وكالة عمون,0,0,1,1,1
قطر,1,0,0,1,1
لبن سحيم,0,0,1,1,1
لقطريين,1,0,0,1,1
ليبيا,0,0,1,1,1
مبارك,0,0,1,1,1
مارس,0,1,0,1,1
مايو,1,0,0,1,1
مجلس الأمة,1,0,0,1,1
معن قطامين,1,0,0,1,1
محمد بن زايد,1,0,0,1,1
محمد بن سلمان,1,0,0,1,1
محمد أمين,0,1,0,1,1
محمد رمضان,1,0,0,1,1
مقتدى الصدر,0,1,0,1,1
ميانمار,0,1,0,1,1
نائب,0,0,1,1,1
نيوزيلندا,0,1,0,1,1
هاني خليفة,0,1,0,1,1
فخر الدين,1,0,0,1,1
U-238,0,1,0,1,1
UAA,0,0,1,1,1
UCLA School of Medicine,1,0,0,1,1
كريم السبكي,1,0,0,1,1
كويتي,1,0,0,1,1
كلية هارفارد,0,0,1,1,1
UK parliament,0,1,0,1,1
Um,1,0,0,1,1
Un año,0,1,0,1,1
un segundo,0,1,0,1,1
una semana,0,0,1,1,1
Under the Rainbow,0,0,1,1,1
United Nations headquarters,1,0,0,1,1
United Nations Human Rights Council,0,0,1,1,1
United Wa State Army,0,0,1,1,1
Universidad de Boston,0,1,0,1,1
Universidad del Rosario,1,0,0,1,1
Universidad Mercer,0,0,1,1,1
"University of California, San Francisco",0,0,1,1,1
University of Michigan,1,0,0,1,1
University of Oxford,0,0,1,1,1
University of Texas Southwestern Medical Center,0,1,0,1,1
University of Virginia,0,1,0,1,1
University of Washington,0,0,1,1,1
Up to Speed,0,0,1,1,1
Upper,0,1,0,1,1
us,0,1,0,1,1
US Air Force,1,0,0,1,1
US Army,0,1,0,1,1
US Coast Guard,0,1,0,1,1
US Commerce Department,0,0,1,1,1
US Department of Education,0,0,1,1,1
US District Court,0,0,1,1,1
US Embassy in Tehran,1,0,0,1,1
US forces in Afghanistan,0,1,0,1,1
US Government,1,0,0,1,1
US Government Accountability Office,0,0,1,1,1
US military,0,0,1,1,1
US National Library of Medicine,1,0,0,1,1
US Sentencing Commission,0,0,1,1,1
Uschi Stokes,0,0,1,1,1
USGS Hawaiian Volcano Observatory,0,0,1,1,1
يد الطبطبائي,0,0,1,1,1
VA hospital,0,0,1,1,1
Vahana,0,1,0,1,1
Valery Gerasimov,0,0,1,1,1
Van Jones,0,0,1,1,1
Vandoorne,0,1,0,1,1
Vanilla Bean,0,1,0,1,1
Venezuelans,1,0,0,1,1
Verrazano-Narrows,0,1,0,1,1
vice chairman,0,1,0,1,1
Vice Chairman,0,1,0,1,1
vicepresidente ejecutivo de Unequal,0,1,0,1,1
Vincent Castello,0,1,0,1,1
Virginia Department of Elections,0,1,0,1,1
Volcán de Fuego,1,0,0,1,1
Wa,0,1,0,1,1
Wa Army,0,1,0,1,1
Warner Bros.,0,0,1,1,1
Washington Los reyes,0,1,0,1,1
Watergate,0,1,0,1,1
"Wednesday, August 30",1,0,0,1,1
"Wednesday, June 6",0,0,1,1,1
Wendy Stovall,0,1,0,1,1
Western Cape,0,0,1,1,1
Western District of Tennessee,0,0,1,1,1
WGO,1,0,0,1,1
Wharton's Center,0,0,1,1,1
White House Sadler,1,0,0,1,1
Whitewater land deal,0,0,1,1,1
wifi,0,0,1,1,1
Wigberto Capo,1,0,0,1,1
Wilford Martinez,0,1,0,1,1
Wilkie,0,1,0,1,1
Wilma,0,1,0,1,1
Windows,0,1,0,1,1
Wizard,0,0,1,1,1
WMBF,1,0,0,1,1
Wolf,0,1,0,1,1
Wopmay,0,1,0,1,1
Workers' Party of Korea,0,0,1,1,1
World Trade Center,0,0,1,1,1
WPDE,1,0,0,1,1
WPVI,0,0,1,1,1
WSB,1,0,0,1,1
www.CNN.com/go,0,0,1,1,1
Xi,1,0,0,1,1
Yahoo,0,1,0,1,1
Yam,1,0,0,1,1
Yana Paskova,0,1,0,1,1
York,0,0,1,1,1
Yuichiro Miura,0,0,1,1,1
Zaghari-Ratcliffe,1,0,0,1,1
Zermatt,0,0,1,1,1
Zermatt Tourism,0,0,1,1,1
Zhangjiajie,0,1,0,1,1
Zhangjiajie National Forest Park,0,1,0,1,1
Zhao Xianming,1,0,0,1,1
Zona del Silencio,0,1,0,1,1
